Ojer kanoq, aretaq chiʼ ri ix, man iwetaʼm ta uwach ri Dyos, ri ix, ix kʼo chuxeʼ ri kikowinem ri qastzij che ma edyos taj;	Ojer kan>oq, aretaq chiʼ ri ix, man iw>etaʼm ta u>wach ri Dyos, ri ix, ix kʼo ch>u>xeʼ ri ki>kowinem ri qastzij ch>e ma e>dyos taj;
Chi awij kʼo jun siwan.	Chi aw>ij kʼo jun siwan.
Xoqujeʼ nakʼut, ri uj uj jeriʼ arechiʼ che uj akʼalabʼ, uj kʼo chuxeʼ ri ukowinem ri jastaq che rech we uwachulew.	Xoqujeʼ nakʼut, ri uj uj jeriʼ arechiʼ ch>e uj akʼal>abʼ, uj kʼo ch>u>xeʼ ri u>kowinem ri jastaq ch>e rech we uwachulew.
Aretaq chiʼ majaʼ kixkojon ri ix, iwetaʼm che ri ix sibʼalaj xixbʼe chkiwach ri ejoʼs taq dyos che man kechʼaw taj.	Aretaq chiʼ majaʼ k>ix>kojon ri ix, iw>etaʼm ch>e ri ix sibʼalaj x>ix>bʼe ch>ki>wach ri e>joʼs taq dyos ch>e man k>e>chʼaw taj.
Xinwilo chi xatwaʼik	X>inw>il>o chi x>at>waʼ>ik
Bolivia	Bolivia
Ri tzijobʼäl Mopan jun chi kech ri mayabʼ tzijobʼäl.	Ri tzijobʼäl M>opan jun chi k>ech ri mayabʼ tzijobʼäl.
kʼatekʼuriʼ, ri ix, ix rech ri Kristo, e ri Kristo rech ri Dyos.	kʼatekʼuriʼ, ri ix, ix rech ri Kristo, e ri Kristo rech ri Dyos.
kok che qʼatbʼaltzij).	k>ok ch>e qʼatbʼaltzij).
E aretaq chiʼ xel uloq ri qʼij, xkʼat ri taq utux e xchaqiʼjarik rumal rech che man kʼo ta ri urabʼ.	E aretaq chiʼ x>el uloq ri qʼij, x>kʼat ri taq u>tux e x>chaqiʼjar>ik r>umal rech ch>e man kʼo ta ri u>rabʼ.
Xsachon kan uyaʼik le pwaq ch.e	X>sachon kan u>yaʼ>ik le pwaq ch.e
akʼalabʼ xuqujeʼ le unajil le tijonik yaʼtal rumal we kʼaxkʼolil.	akʼal>abʼ xuqujeʼ le u>najil le tijonik yaʼtal r>umal we kʼaxkʼolil.
Noʼjim upachʼuxik le nuwiʼ	Noʼjim u>pachʼu>x>ik le nu>wiʼ
Xinbʼe che loqʼoj.	X>in>bʼe ch>e loqʼoj.
Jeʼ nakʼut Nutat, jeʼ kʼuwaʼ ri kawaj.	Jeʼ nakʼut Nu>tat, jeʼ kʼuwaʼ ri k>awaj.
Tekʼuriʼ ekʼo kebʼ achijabʼ ketzijon rukʼ, eʼare ri Moʼises e ri Eliʼas;	Tekʼuriʼ ekʼo kebʼ achij>abʼ k>e>tzijon r>ukʼ, eʼare ri Moʼises e ri Eliʼas;
tobʼanelabʼ ri keʼpe jelaʼ Europa; e kʼi na ri tobʼanelabʼ ri kʼi	tobʼanel>abʼ ri k>eʼ>pe jelaʼ Europa; e kʼi na ri tobʼanel>abʼ ri kʼi
Xoqujeʼ, ri bʼaqilal, man kʼo ta xaq jun utzʼaqatil, xane kʼi ri utzʼaqatil kʼolik.	Xoqujeʼ, ri bʼaqilal, man kʼo ta xaq jun u>tzʼaqatil, xane kʼi ri u>tzʼaqatil kʼol>ik.
Maj jachin xʼek	Maj jachin x>ʼe>k
xoqujeʼ, konojel ri eʼachalaxik che ekʼo wukʼ ri in, chkech ri Ekomon Tyox rech ri Galasiʼa.	xoqujeʼ, k>onojel ri eʼ>achalaxik ch>e ekʼo w>ukʼ ri in, ch>k>ech ri E>komon Tyox rech ri Galasiʼa.
wi ri unoʼj.	wi ri u>noʼj.
Kaqʼan pa ri jun jukubʼ, kqʼax chʼaqap, kʼatekʼuriʼ kpe pa ri utinimit.	K>aqʼan pa ri jun jukubʼ, k>qʼax chʼaqap, kʼatekʼuriʼ k>pe pa ri u>tinimit.
Na xintaqchiʼj ta le wachajil kachakunik	Na x>in>taqchiʼ>j ta le w>achajil ka>chakun>ik
Pero noʼjimal petnaq loq,	Pero noʼjimal pet>naq loq,
arech ri ix, rukʼ junam iwanimaʼ e junam rukʼ ichiʼ nim kiwil wi ri Dyos, ri Utatxel ri Qajawxel Jesus Kristo.	arech ri ix, r>ukʼ junam iw>animaʼ e junam r>ukʼ i>chiʼ nim ki>wil wi ri Dyos, ri U>tatxel ri Q>ajawxel Jesus Kristo.
Ri eʼareʼ man kʼo ta kalkʼuwaʼl, rumal che menchoʼr ri Xper, xoqujeʼ chi ekebʼ eriʼj taq winaq chik.	Ri eʼareʼ man kʼo ta k>alkʼuwaʼl, r>umal ch>e menchoʼr ri Xper, xoqujeʼ chi e>kebʼ e>riʼj taq winaq chik.
Aretaq chiʼ okʼowinaq chi ri kebʼ qʼij riʼ, kel ubʼik, kbʼe ubʼi pa ri Galileʼa.	Aretaq chiʼ okʼowinaq chi ri kebʼ qʼij riʼ, k>el ubʼik, k>bʼe u>bʼi pa ri Galileʼa.
arech ronojel ri kkojon chrech ri areʼ kkʼojiʼ jun junalik ukʼaslemal rumal ri areʼ.	arech r>onojel ri k>kojon ch>r>ech ri areʼ k>kʼojiʼ jun junalik u>kʼaslemal r>umal ri areʼ.
KʼO KICHOQʼABʼ	KʼO KI>CHOQʼABʼ
pa ri utzij qʼatbʼaltzij.	pa ri u>tzij qʼatbʼaltzij. 
E kʼo jobʼ umiʼal, ri nutat.	E kʼo jobʼ u>miʼal, ri nu>tat.
Jun ujunabʼ ri akʼal.	Jun u>junabʼ ri akʼal.
chi ma pa ri kʼisbʼal ta kʼo wi wa Iximulew chi ma e kʼi ta ri winaq	chi ma pa ri kʼisbʼal ta kʼo wi wa Iximulew chi ma e kʼi ta ri winaq
Xoqujeʼ ri eʼareʼ che xewar ubʼi rukʼ ri Kristo, xesach na kʼuriʼ.	Xoqujeʼ ri eʼareʼ ch>e x>e>war u>bʼi r>ukʼ ri Kristo, x>e>sach na kʼuriʼ.
Kʼi tinamit e kʼo pa chʼoʼj.	Kʼi tinamit e kʼo pa chʼoʼj.
Ri al Ixchel, kuchomaj chi ri unan,	Ri al Ixchel, k>u>choma>j chi ri u>nan,
Ri jun achi kbʼe che ubʼixik chkech ri eʼajjudiʼo, che are ri Jesus xkunan ri areʼ.	Ri jun achi k>bʼe ch>e u>bʼixik ch>k>ech ri eʼ>ajjudiʼo, ch>e are ri Jesus x>kunan ri areʼ.
Ri jun che kʼo ri Kʼojolxel rukʼ, kkʼojiʼ ri kʼaslemal rukʼ; ri jun che man kʼo ta ri Kʼojolxel rukʼ man kʼo ta riʼ ri kʼaslemal rukʼ.	Ri jun ch>e kʼo ri Kʼojolxel r>ukʼ, k>kʼojiʼ ri kʼaslemal r>ukʼ; ri jun ch>e man kʼo ta ri Kʼojolxel r>ukʼ man kʼo ta riʼ ri kʼaslemal r>ukʼ.
Kojbʼinik	K>oj>bʼin>ik
Kawaj kinʼek	Ka>w>a>j k>in>ʼe>k
Xinbʼij chi kinʼek	X>in>bʼi>j chi k>in>ʼe>k
Rumal rech, jachin kok pa ri ruxlanem, xoqujeʼ kuxlan riʼ che taq ri uchak, jeriʼ jacha ri Dyos che xuxlan chech taq ri uchak.	R>umal rech, jachin k>ok pa ri r>uxlanem, xoqujeʼ k>uxlan riʼ ch>e taq ri u>chak, jeriʼ jacha ri Dyos ch>e x>uxlan ch>ech taq ri u>chak.
Kʼatekʼut, aretaq chiʼ ri in kinkʼastaj na, kinbʼe na in nabʼe chiwach pa ri Galileʼa».	Kʼatekʼut, aretaq chiʼ ri in k>in>kʼastaj na, k>in>bʼe na in nabʼe ch>i>wach pa ri Galileʼa».
ri kʼo wakamik.	ri kʼo wakamik.
Are ri ixoq xinsikʼin uloq	Are ri ixoq x>in>sikʼi>n uloq
¡Chkanaj ta bʼaʼ iwukʼ ri utoqʼobʼ ri Qajawxel Jesus Kristo!	¡Ch>kanaj ta bʼaʼ iw>ukʼ ri u>toqʼobʼ ri Q>ajawxel Jesus Kristo!
Ri jun che kchʼoʼjin rukʼ ri kowinem, xoqujeʼ kchʼoʼjin rukʼ ri Dyos. Kʼatekʼuriʼ, ri jachintaq man keniman ta chkech ri eʼareʼ, kʼo riʼ ri qʼatojtzij pakiwiʼ.	Ri jun ch>e k>chʼoʼjin r>ukʼ ri kowinem, xoqujeʼ k>chʼoʼjin r>ukʼ ri Dyos. Kʼatekʼuriʼ, ri jachintaq man k>e>niman ta ch>k>ech ri eʼareʼ, kʼo riʼ ri qʼatojtzij pa>ki>wiʼ.
pa ri areʼ, xoqujeʼ ri ix, ix kʼo pa ri ja, arech ri ix ix jun rachoch ri Dyos pa ri Uxlabʼxel.	pa ri areʼ, xoqujeʼ ri ix, ix kʼo pa ri ja, arech ri ix ix jun r>achoch ri Dyos pa ri Uxlabʼxel.
¡Man jeriʼ ta kʼut! Ri Kristo xkʼastaj uwach chkixoʼl ri ekaminaqibʼ, are nabʼe chkixoʼl ri xewarik.	¡Man jeriʼ ta kʼut! Ri Kristo x>kʼastaj u>wach ch>ki>xoʼl ri e>kaminaq>ibʼ, are nabʼe ch>ki>xoʼl ri x>e>war>ik.
Kbʼix chrech, che are ri Jesus Nasareʼo ri tajin kqʼatanik.	K>bʼix ch>r>ech, ch>e are ri Jesus Nasareʼo ri tajin k>qʼatan>ik.
México	México
Xuqʼiʼo xkamsax ri rachalal	X>u>qʼiʼ>o x>kam>sa>x ri r>achalal
Ri xtukʼ kelik we kaxeʼj awibʼ.	Ri xtukʼ k>el>ik we ka>xeʼj aw>ibʼ.
Xqʼax ri nimaqʼij rech ri junabʼ.	X>qʼax ri nimaqʼij rech ri junabʼ.
¡Kʼatekʼut, ri ix, are nim kiwil wi ri inimal! Ronojel nimal, che jeriʼ, xas itzel wi.	¡Kʼatekʼut, ri ix, are nim ki>wil wi ri i>nimal! R>onojel nimal, ch>e jeriʼ, xas itzel wi.
Julajuj qʼataj. Ri yaʼtal chech ri winaq kʼo pa kʼaxkʼolil.	Julajuj qʼataj. Ri yaʼtal ch>ech ri winaq kʼo pa kʼaxkʼolil.
Chi raqän kabʼin wi ri tataʼ.	Chi r>aqän ka>bʼin wi ri tataʼ.
waʼ ri ubʼantajik.	waʼ ri u>bʼantajik.
tzij re ri tinimit ri kakʼamow wi ubʼi jun chomanik ke konojel ri	tzij r>e ri tinimit ri ka>kʼamow wi u>bʼi jun chomanik k>e k>onojel ri
Jawijeʼ, xok wi nabʼe ri Jesus rumal toqʼobʼisabʼal qawach ri uj; ri areʼ che kamik riʼ junalikalaj nim chuchqajaw rech ri uwachulew jeriʼ jacha ri ubʼantajik ri Melkisedek.	Jawijeʼ, x>ok wi nabʼe ri Jesus r>umal toqʼobʼisabʼal qa>wach ri uj; ri areʼ ch>e kamik riʼ junalik>alaj nim chuchqajaw rech ri uwachulew jeriʼ jacha ri u>bʼantajik ri Melkisedek.
Qʼinom ri achi.	Qʼinom ri achi.
Pa ri suʼt pisom wi ri lej.	Pa ri suʼt pisom wi ri lej.
jun chi Dyos e Tatxel qech qonojel; ri Areʼ che kʼo pakiwiʼ chi nimalaj konojel, ri areʼ che kʼo kumal konojel e ri areʼ che kʼo pa konojel.	jun chi Dyos e Tatxel q>ech q>onojel; ri Areʼ ch>e kʼo pa>ki>wiʼ chi nimalaj k>onojel, ri areʼ ch>e kʼo k>umal k>onojel e ri areʼ ch>e kʼo pa k>onojel.
Ri chʼima kʼa tʼon na.	Ri chʼima kʼa tʼon na.
Ri oj kʼo ajchaqʼe.	Ri oj kʼo ajchaqʼe.
Eʼachalaxik, ri ix, ¿On man iwetaʼm taj –ri in kinchʼaw kukʼ ri jachin taq eʼajtijabʼ rech ri pixabʼ– che ri winaq xuwi kʼo chuxeʼ ri Pixabʼ pa ri ukʼaslemal?	Eʼachalaxik, ri ix, ¿On man iw>etaʼm taj –ri in k>in>chʼaw k>ukʼ ri jachin taq eʼ>ajtij>abʼ rech ri pixabʼ– ch>e ri winaq xuwi kʼo ch>u>xeʼ ri Pixabʼ pa ri u>kʼaslemal?
Juwinaq wajxaqibʼ qʼataj.	Juwinaq wajxaqibʼ qʼataj.
Ri kotzʼiʼj kʼixtan katijowik.	Ri kotzʼiʼj kʼixtan ka>tijow>ik.
Xraj kaatʼek	X>r>aj ka>at>ʼe>k
E kʼo lajuj wakʼ.	E kʼo lajuj w>akʼ.
Utz ukemik le pas chawe	Utz u>kem>ik le pas ch>aw>e
Jeʼ nakʼut, ri ojer kanoq, man kʼo ta ri Pixabʼ; kʼatekʼut aretaq chiʼ xpe ri Pixabʼ, ri makaj xkʼojiʼ ukʼaslemal	Jeʼ nakʼut, ri ojer kan>oq, man kʼo ta ri Pixabʼ; kʼatekʼut aretaq chiʼ x>pe ri Pixabʼ, ri makaj x>kʼojiʼ u>kʼaslemal
Ekʼo sibʼalaj winaq che kʼo ri kikojonik kebʼek, keʼok rukʼ ri Ajawxel; sibʼalaj ekʼi achijabʼ e ixoqibʼ.	Ekʼo sibʼalaj winaq ch>e kʼo ri ki>kojonik k>e>bʼe>k, k>eʼ>ok r>ukʼ ri Ajawxel; sibʼalaj ekʼi achij>abʼ e ixoq>ibʼ.
Xax rij mansaʼn.	Xax r>ij mansaʼn.
jeʼ jas ri tzʼibʼatalik: Man kʼo ta jun che sukʼ,	jeʼ jas ri tzʼibʼatalik: Man kʼo ta jun ch>e sukʼ,
Kʼatekʼuriʼ, aretaq chiʼ ri eʼareʼ junam kechʼaw chkiwach, kqibʼ ukoq ri Jesus kukʼ e kbʼin kukʼ.	Kʼatekʼuriʼ, aretaq chiʼ ri eʼareʼ junam k>e>chʼaw ch>ki>wach, k>qibʼ uk>oq ri Jesus k>ukʼ e k>bʼin k>ukʼ.
Kʼo kʼatän che ri akʼal.	Kʼo kʼatän ch>e ri akʼal.
Pa we jastaq riʼ, ri at man kʼo ta awech chrech, xoqujeʼ man kʼo ta waʼ awechbʼal chrech, rumal rech che le awanimaʼ man sukʼ ta chuwach ri Dyos.	Pa we jastaq riʼ, ri at man kʼo ta aw>ech ch>r>ech, xoqujeʼ man kʼo ta waʼ aw>echbʼal ch>r>ech, r>umal rech ch>e le aw>animaʼ man sukʼ ta ch>u>wach ri Dyos.
Kbʼe ubʼi chilaʼ e kok pa jun Kʼolbʼal kichʼabʼal ri eʼareʼ.	K>bʼe u>bʼi chilaʼ e k>ok pa jun Kʼolbʼal ki>chʼabʼal ri eʼareʼ.
¿La man yaʼtal ta chqech uj che kujwaʼik e kujqumunik?	¿La man yaʼtal ta ch>q>ech uj ch>e k>uj>waʼ>ik e k>uj>qumu>n>ik?
Ri jun che naj kbʼe wi e man kkanaj ta kan pa ri utzij ri Kristo man kʼo ta riʼ ri Dyos rukʼ. Ri jun che kkanaj kan pa ri tzij kkʼojiʼ ri Tatxel e ri Kʼojolxel rukʼ.	Ri jun ch>e naj k>bʼe wi e man k>kanaj ta kan pa ri u>tzij ri Kristo man kʼo ta riʼ ri Dyos r>ukʼ. Ri jun ch>e k>kanaj kan pa ri tzij k>kʼojiʼ ri Tatxel e ri Kʼojolxel r>ukʼ.
Junam kijunabʼ.	Junam ki>junabʼ.
ri kachakun pa uwiʼ ri bʼantajik pa wa Iximulew, rajawixik chi ma	ri ka>chakun pa u>wiʼ ri bʼantajik pa wa Iximulew, rajawixik chi ma
Pa we taq qʼij riʼ, ri Mariʼy kel ubʼik, chanim kel ubʼik, kbʼe pa ri juyubʼ, pa jun utinamit ri Juda.	Pa we taq qʼij riʼ, ri Mariʼy k>el ubʼik, chanim k>el ubʼik, k>bʼe pa ri juyubʼ, pa jun u>tinamit ri Juda.
¡Kkʼojiʼ bʼaʼ ri usipanik ri ajawxel Jesus Kristo rukʼ ri awuxlabʼal!	¡K>kʼojiʼ bʼaʼ ri u>sipanik ri ajawxel Jesus Kristo r>ukʼ ri aw>uxlabʼal!
Tza ri choʼm.	Tza ri choʼm.
Juwinaq wajxaqlajuj qʼataj.	Juwinaq wajxaqlajuj qʼataj.
tinimit chik. xuqujeʼ kʼo nikʼaj jasa taq chik ri kʼax rilik ri ma	tinimit chik. xuqujeʼ kʼo nikʼaj jasa taq chik ri kʼax rilik ri ma
Xinnaʼo chi katpetik	X>in>naʼ>o chi k>at>pet>ik
ojer xok kan che nimalaj qʼatbʼaltzij re ri nimalaj tinimit ubʼiʼ	ojer x>ok kan ch>e nimalaj qʼatbʼaltzij r>e ri nimalaj tinimit u>bʼiʼ
Ri eʼajkʼayibʼ erech ri uwachulew koqʼej na uwach riʼ e kebʼison na riʼ chech; ri eqaʼn upam taq ri jukubʼ, kamik riʼ man kʼo ta chi jun kloqʼowik!	Ri eʼ>ajkʼay>ibʼ e>r>ech ri uwachulew k>oqʼej na u>wach riʼ e k>e>bʼison na riʼ ch>ech; ri eqaʼn u>pam taq ri jukubʼ, kamik riʼ man kʼo ta chi jun k>loqʼow>ik!
Jawi xojʼe wi chuloqʼik?	Jawi x>oj>ʼe wi ch>u>loqʼ>ik?
Kebʼ nubʼiʼ kʼolik.	Kebʼ nu>bʼiʼ kʼol>ik.
Kʼatekʼuriʼ kbʼe utzijol pa ronojel taq ukʼolbʼal ri ulew chilaʼ.	Kʼatekʼuriʼ k>bʼe u>tzijol pa r>onojel taq u>kʼolbʼal ri ulew chilaʼ.
Kʼo jubʼiqʼ awech.	Kʼo jubʼiqʼ aw>ech.
¿weriʼ, are ri Ajawxel xbʼanowik e sibʼalaj utz mayibʼal chuwach ri qawoqʼoch?».	¿weriʼ, are ri Ajawxel x>bʼan>ow>ik e sibʼalaj utz mayibʼal ch>u>wach ri qa>woqʼoch?».
Kamul xinpe che atzukuxik.	Kamul x>in>pe ch>e a>tzukuxik.
Aninäq kwaj ri nuwa. (	Aninäq k>w>aj ri nu>wa. (
Najil upam ri siwan.	Najil u>pam ri siwan.
Xinwilo chi takʼalik xulik	X>inw>il>o chi takʼ>al>ik x>ul>ik
Xa jekʼuriʼ, kʼo kʼi utzʼaqatil, kʼatekʼut xa jun chi bʼaqilal.	Xa jekʼuriʼ, kʼo kʼi u>tzʼaqatil, kʼatekʼut xa jun chi bʼaqilal.
Kawinaq wuqlajuj qʼataj.	Kawinaq wuqlajuj qʼataj.
Kakʼal ujunabʼ ri nunan.	K>akʼal u>junabʼ ri nu>nan.
Xukʼutu rech kaqilo	X>u>kʼut>u r>ech ka>q>il>o
Ri alaj a Xep kʼo pa ri nabʼe tijonem.	Ri alaj a Xep kʼo pa ri nabʼe tijonem.
Chom ri aq.	Chom ri aq.
Kinbʼinik xinʼek	K>in>bʼin>ik x>in>ʼe>k
Na jupulik ta xeqaj (laʼkʼalabʼ)	Na jup>ul>ik ta x>e>qaj (laʼkʼalabʼ)
Xojkisikʼij	X>oj>ki>sikʼi>j
Qastzij nakʼut, che ri in, man in kʼo ta iwukʼ chi rukʼ ri nubʼaqil; kʼatekʼut, ri in, in kʼo iwukʼ rukʼ ri wuxlabʼal; sibʼalaj kinkiʼkotik rumal rech che sibʼalaj kʼo utzil kiʼkotemal chixoʼl e rumal che kixkojon chrech ri Kristo.	Qastzij nakʼut, ch>e ri in, man in kʼo ta iw>ukʼ chi r>ukʼ ri nu>bʼaqil; kʼatekʼut, ri in, in kʼo iw>ukʼ r>ukʼ ri w>uxlabʼal; sibʼalaj k>in>kiʼkot>ik r>umal rech ch>e sibʼalaj kʼo utzil kiʼkotemal ch>i>xoʼl e r>umal ch>e k>ix>kojon ch>r>ech ri Kristo.
Ri al Ixchel, xuqʼiʼo	Ri al Ixchel, x>u>qʼiʼ>o
Chbʼana jun utzil chi we.	Ch>bʼan>a jun utzil chi we.
Ri uchʼuʼjilal ri ali Toʼn.	Ri u>chʼuʼjilal ri ali Toʼn.
Wech ri suʼt säq uwach kʼo chi upam ri ja.	W>ech ri suʼt säq u>wach kʼo chi u>pam ri ja.
Ri ix iwetaʼm: rukʼ waʼ we kʼax riʼ, ri ikojonik kkʼojiʼ uchuqʼabʼ;	Ri ix iw>etaʼm: r>ukʼ waʼ we kʼax riʼ, ri i>kojonik k>kʼojiʼ u>chuqʼabʼ;
Are ri utat ri Max kpetik.	Are ri u>tat ri Max k>pet>ik.
Arechiʼ kel uloq pa ri ukʼolbʼal chʼabʼal, kpe kukʼ ri Santiʼago e ri Xwan pa ri rachoch ri Simon e ri Atrix.	Arechiʼ k>el uloq pa ri u>kʼolbʼal chʼabʼal, k>pe k>ukʼ ri Santiʼago e ri Xwan pa ri r>achoch ri Simon e ri Atrix.
Ri unan e ri erachalal kepe uloq rukʼ ri areʼ, kʼatekʼuriʼ, man kekowin taj keqibʼ ukoq rukʼ, rumal rech che ekʼo sibʼalaj winaq.	Ri u>nan e ri e>r>achalal k>e>pe uloq r>ukʼ ri areʼ, kʼatekʼuriʼ, man k>e>kowin taj k>e>qibʼ uk>oq r>ukʼ, r>umal rech ch>e ekʼo sibʼalaj winaq.
We man kʼo ta kʼastajibʼal wach chkixoʼl ri ekaminaqibʼ, xoqujeʼ man xkʼastaj ta kʼu uwach riʼ ri Kristo.	We man kʼo ta kʼastajibʼal wach ch>ki>xoʼl ri e>kaminaq>ibʼ, xoqujeʼ man x>kʼastaj ta kʼu u>wach riʼ ri Kristo.
Tekʼuriʼ, chkijujunal kebʼe bʼi cho taq kachoch.	Tekʼuriʼ, chkijujunal k>e>bʼe bʼi cho taq k>achoch.
E kʼo utobʼanelabʼ ri ajtʼisoʼm.	E kʼo u>tobʼanel>abʼ ri ajtʼisoʼm.
Xretaʼmaj waʼim	X>r>etaʼma>j waʼ>im
Jeʼ na kʼut, jas ri bʼaqilal; we ri bʼaqilal man kʼo ta ruxlabʼal xas kaminaq wi riʼ, xoqujeʼ, ri kojonik che man kʼo ta uchak xas kaminaq na kʼuriʼ.	Jeʼ na kʼut, jas ri bʼaqilal; we ri bʼaqilal man kʼo ta r>uxlabʼal xas kaminaq wi riʼ, xoqujeʼ, ri kojonik ch>e man kʼo ta u>chak xas kaminaq na kʼuriʼ.
Le winaq pa le chʼichʼ e tʼuyul lo wi	Le winaq pa le chʼichʼ e tʼuy>ul lo wi
Kujopan pa ri Sirakusa e kujkanaj kan chilaʼ oxibʼ qʼij.	K>uj>opan pa ri Sirakusa e k>uj>kanaj kan chilaʼ oxibʼ qʼij.
In ri in wa rech kʼaslemal.	In ri in wa rech kʼaslemal.
Jeʼl ktijow ri kär.	Jeʼl k>tijow ri kär.
Jeʼl kʼolem chi awachoch.	Jeʼl kʼolem chi aw>achoch.
Xoqujeʼ waral riʼ, ri Pabʼlo katzijon kukʼ ri eʼareʼ. Pa oxibʼ Sabʼado kchʼaw kukʼ puwiʼ ri Tzij.	Xoqujeʼ waral riʼ, ri Pabʼlo ka>tzijon k>ukʼ ri eʼareʼ. Pa oxibʼ Sabʼado k>chʼaw k>ukʼ p>u>wiʼ ri Tzij.
Ri ix, man ix kʼo ta pa ri bʼaqilal, xane ix kʼo pa ri uxlabʼxel, rumal rech che ri Uxlabʼxel rech ri Dyos kʼo rachoch iwukʼ ri ix. Jachin ri man kʼo ta ri Uxlabʼxel rech ri Kristo rukʼ, ri areʼ man rech ta ri Kristo,	Ri ix, man ix kʼo ta pa ri bʼaqilal, xane ix kʼo pa ri uxlabʼxel, r>umal rech ch>e ri Uxlabʼxel rech ri Dyos kʼo r>achoch iw>ukʼ ri ix. Jachin ri man kʼo ta ri Uxlabʼxel rech ri Kristo r>ukʼ, ri areʼ man rech ta ri Kristo,
Xepetik xolkikʼamaʼ	X>e>pet>ik x>ol>ki>kʼam>aʼ
Xuta le nimalaj kʼamol bʼe rech	X>u>ta le nim>alaj kʼam>ol bʼe r>ech
Kʼakʼ ri abʼ.	Kʼakʼ ri abʼ.
Kamul kinwaʼ na.	Kamul k>in>waʼ na.
E ri alitomabʼ taq erachalal, ¿la man ekʼo ta konojel ri eʼareʼ chqaxoʼl ri uj? ¿Jawijeʼ kpe wi chrech ronojel we riʼ?».	E ri alitom>abʼ taq e>r>achalal, ¿la man ekʼo ta k>onojel ri eʼareʼ ch>qa>xoʼl ri uj? ¿Jawijeʼ k>pe wi ch>r>ech r>onojel we riʼ?».
Kpe na ri qʼatoj tzij.	K>pe na ri qʼatoj tzij.
In, che in chäj, inpetinaq uloq pa we uwachulew arech ronojel ri kkojon chwech ri in man kkanaj ta kan pa ri qʼequʼmal.	In, ch>e in chäj, in>petinaq uloq pa we uwachulew arech r>onojel ri k>kojon ch>w>ech ri in man k>kanaj ta kan pa ri qʼequʼmal.
Xretaʼmaj	X>r>etaʼma>j
E kʼo ri qachalal pa Chi uwiʼ la.	E kʼo ri q>achalal pa Chi u>wiʼ la.
Na xinta taj	Na x>in>ta taj
Kawinaq kebʼ qʼataj.	Kawinaq kebʼ qʼataj.
Ri Jose, xoqujeʼ kpe uloq pa ri Galileʼa, kel uloq pa ri tinamit Nasaret, kopan pa ri Judeʼa, pa ri utinamit ri David, che Bʼelem ri ubʼiʼ, –rumal che ri areʼ kʼo rech chkech ri uwinaq ri David–	Ri Jose, xoqujeʼ k>pe uloq pa ri Galileʼa, k>el uloq pa ri tinamit Nasaret, k>opan pa ri Judeʼa, pa ri u>tinamit ri David, ch>e Bʼelem ri u>bʼiʼ, –r>umal ch>e ri areʼ kʼo rech ch>k>ech ri u>winaq ri David–
Kʼo kan wa rech kaqatijo	Kʼo kan wa r>ech ka>qa>tij>o
Kojpetik kolqakʼamaʼ	K>oj>pet>ik k>ol>qa>kʼam>aʼ
Kʼatekʼuriʼ, chiwech ri ix, che xita ri jastaq uwach chi pa ri umajibʼal uloq chkanaj bʼaʼ kan iwukʼ ri ix. We kkanaj kan iwukʼ ri ix ri jastaq che xita pa ri umajibʼal, xoqujeʼ ri ix, kixkanaj kan riʼ pa ri Kʼojolxel e pa ri Tatxel.	Kʼatekʼuriʼ, ch>iw>ech ri ix, ch>e xit>a ri jastaq u>wach chi pa ri u>majibʼal uloq ch>kanaj bʼaʼ kan iw>ukʼ ri ix. We k>kanaj kan iw>ukʼ ri ix ri jastaq ch>e xit>a pa ri u>majibʼal, xoqujeʼ ri ix, k>ix>kanaj kan riʼ pa ri Kʼojolxel e pa ri Tatxel.
ri man eʼajjudiʼo taj xoqujeʼ kʼo ri kechbʼal, ri eʼareʼ eʼutzʼaqatil ri jun Bʼaqilal, kʼo ri chiʼnik kukʼ, pa ri Kristo Jesus rumal ri Utzalaj Tzij.	ri man eʼ>ajjudiʼo taj xoqujeʼ kʼo ri k>echbʼal, ri eʼareʼ eʼ>u>tzʼaqatil ri jun Bʼaqilal, kʼo ri chiʼnik k>ukʼ, pa ri Kristo Jesus r>umal ri Utzalaj Tzij.
¿La man iwetaʼm taj, che ri eʼajchakibʼ chrech ri nim rachoch ri Dyos chi kʼo ri kipwaq che rech ri nim rachoch ri Dyos? ¿La man iwetaʼm taj che ri kechakun cho ri tabʼal ekebʼ riʼ chrij ri jastaq rukʼ ri tabʼal?	¿La man iw>etaʼm taj, ch>e ri eʼ>ajchak>ibʼ ch>r>ech ri nim r>achoch ri Dyos chi kʼo ri ki>pwaq ch>e rech ri nim r>achoch ri Dyos? ¿La man iw>etaʼm taj ch>e ri k>e>chakun cho ri tabʼal e>kebʼ riʼ ch>r>ij ri jastaq r>ukʼ ri tabʼal?
ronojel tatxel che kʼo pa ri kaj e pa ri uwachulew kʼo ri ubʼiʼ rukʼ ri Areʼ.	r>onojel tatxel ch>e kʼo pa ri kaj e pa ri uwachulew kʼo ri u>bʼiʼ r>ukʼ ri Areʼ.
Jeʼ nakʼut, ix ri ix qaqʼijil e ix ri ix qakiʼkotemal.	Jeʼ nakʼut, ix ri ix qa>qʼijil e ix ri ix qa>kiʼkotemal.
Xwaj chi xatʼe taj	X>w>aj chi x>at>ʼe taj
Chrech we kebʼ pixabʼ riʼ tzuyulik ronojel ri pixabʼ e etzuyulik ri eqʼaxal utzij ri Dyos».	Ch>r>ech we kebʼ pixabʼ riʼ tzuyulik r>onojel ri pixabʼ e e>tzuyulik ri e>qʼaxal u>tzij ri Dyos».
Xiʼnwilaʼ	X>iʼnw>il>aʼ
Kʼo ri Anas, ri nimalaj chuchqajaw, kʼo ri Kaʼifas, ri Jonatan, ri Alejandro e konojel ri winaq che enim taq chuchqajawibʼ.	Kʼo ri Anas, ri nimalaj chuchqajaw, kʼo ri Kaʼifas, ri Jonatan, ri Alejandro e k>onojel ri winaq ch>e e>nim taq chuchqajaw>ibʼ.
Kekʼiy ri amolo chi upam ri mes.	K>e>kʼiy ri amolo chi u>pam ri mes.
Xukachʼ rukʼ le uware	X>u>kachʼ r>ukʼ le u>ware
Jeʼ nakʼut, ekʼo ejujun chik che ekʼo chi rukʼ ri Satanas.	Jeʼ nakʼut, ekʼo e>jujun chik ch>e ekʼo chi r>ukʼ ri Satanas.
Rumal rech, ri areʼ che kbʼix weriʼ puwiʼ, ri areʼ rech jun chik juqʼat, e chrech we juqʼat riʼ, man kʼo ta jun winaq xpatanajik pa ri tabʼal toqʼobʼ.	R>umal rech, ri areʼ ch>e k>bʼix weriʼ p>u>wiʼ, ri areʼ rech jun chik juqʼat, e ch>r>ech we juqʼat riʼ, man kʼo ta jun winaq x>patanaj>ik pa ri tabʼal toqʼobʼ.
Jas xataqchiʼj le akʼal chutijik ?	Jas x>a>taqchiʼ>j le akʼal ch>u>tij>ik ?
Man utz ta riʼ che enikʼaj winaq chik kʼo ronojel jastaq kech, kʼatekʼuriʼ ri ix man kʼo ta chi ijastaq, are rajawaxik che junam ri ijastaq kʼolik.	Man utz ta riʼ ch>e e>nikʼaj winaq chik kʼo r>onojel jastaq k>ech, kʼatekʼuriʼ ri ix man kʼo ta chi i>jastaq, are rajawaxik ch>e junam ri i>jastaq kʼol>ik.
Xoqujeʼ, ri Areʼ xbʼe che ubʼixik ri Tzij, chkech ri ekʼo pa cheʼ,	Xoqujeʼ, ri Areʼ x>bʼe ch>e u>bʼixik ri Tzij, ch>k>ech ri ekʼo pa cheʼ,
Kajuluw ri aqʼaʼl chi uxeʼ ri tʼuʼy.	Ka>juluw ri aqʼaʼl chi u>xeʼ ri tʼuʼy.
Xa jekʼuriʼ, ri Pedro kʼo ikim cho ja, kopan jun umokom ri nim chuchqajaw.	Xa jekʼuriʼ, ri Pedro kʼo ikim cho ja, k>opan jun u>mokom ri nim chuchqajaw.
94. Chirij kan ri junabʼ re ri 1997 wa Iximulew ma tinimit taj ri katoʼ	94. Chi>r>ij kan ri junabʼ r>e ri 1997 wa Iximulew ma tinimit taj ri ka>toʼ
Kaxlaʼn xan ri wachoch.	Kaxlaʼn xan ri w>achoch.
Saq chi kan le ichaj rech katzako	Saq chi kan le ichaj r>ech k>a>tzak>o
Kʼatekʼut, rajawaxik che jun winaq knimanik, man xuwi ta rumal ri xibʼrikil chuwach ri qʼatbʼaltzij, xane xoqujeʼ rumal ri uchomanik pa ranimaʼ.	Kʼatekʼut, rajawaxik ch>e jun winaq k>niman>ik, man xuwi ta r>umal ri xibʼrikil ch>u>wach ri qʼatbʼaltzij, xane xoqujeʼ r>umal ri u>chomanik pa r>animaʼ.
chech areʼ ma kʼo ta jun tinimit kʼo pa kiwiʼ. Waʼ jun noʼj waʼ ri	ch>ech areʼ ma kʼo ta jun tinimit kʼo pa ki>wiʼ. Waʼ jun noʼj waʼ ri
Kopan chuwach ri Pilato, kʼatekʼuriʼ, kuta ri ubʼaqil ri Jesus chrech.	K>opan ch>u>wach ri Pilato, kʼatekʼuriʼ, kut>a ri u>bʼaqil ri Jesus ch>r>ech.
Juwinaq oxibʼ qʼataj.	Juwinaq oxibʼ qʼataj.
Kinwoyʼej katpetik8	K>inw>oyʼe>j k>at>pet>ik8
Kʼatekʼuriʼ, kamik riʼ, pa ri Kristo Jesus, ri ix che ojer naj ix kʼo wiʼ, ri ix chunaqaj chik ix kʼo wi, rumal ri ukikʼel ri Kristo.	Kʼatekʼuriʼ, kamik riʼ, pa ri Kristo Jesus, ri ix ch>e ojer naj ix kʼo wiʼ, ri ix ch>u>naqaj chik ix kʼo wi, r>umal ri u>kikʼel ri Kristo.
Aretaq chiʼ ri areʼ kʼo cho ri mexa pa ja rukʼ ri Mateʼo, sibʼalaj ekʼi eʼajtoqʼinelabʼ e eʼajmakibʼ keʼopan cho ri mexa kukʼ ri Jesus e ri eʼutijoxelabʼ.	Aretaq chiʼ ri areʼ kʼo cho ri mexa pa ja r>ukʼ ri Mateʼo, sibʼalaj ekʼi eʼ>ajtoqʼinel>abʼ e eʼ>ajmak>ibʼ k>eʼ>opan cho ri mexa k>ukʼ ri Jesus e ri eʼ>u>tijoxel>abʼ.
chi, chi ke ri areʼ ri utzij qʼatbʼaltzij.	chi, chi k>e ri areʼ ri u>tzij qʼatbʼaltzij.
Bolivia.	Bolivia.
Kachuqʼchut ri jaʼ chi apam.	Ka>chuqʼchut ri jaʼ chi a>pam.
Kʼatekʼut, nim chi na chuwach weriʼ; ri Rebʼeka yawabʼ ixoq chik rumal xuwi jun achi, che are ri Isaʼak qatat;	Kʼatekʼut, nim chi na ch>u>wach weriʼ; ri Rebʼeka yawabʼ ixoq chik r>umal xuwi jun achi, ch>e are ri Isaʼak qa>tat;
Chom ri a Max.	Chom ri a Max.
Rumal rech che ri umoxil ri Dyos are nim retaʼmabʼal chuwach ri ketaʼmabʼal ri winaq, e ri utuʼqaril ri Dyos are nim uchuqʼabʼ chuwach ri kichuqʼabʼ ri winaq.	R>umal rech ch>e ri u>moxil ri Dyos are nim r>etaʼmabʼal ch>u>wach ri k>etaʼmabʼal ri winaq, e ri u>tuʼqaril ri Dyos are nim u>chuqʼabʼ ch>u>wach ri ki>chuqʼabʼ ri winaq.
Tijonik	Tijonik
Aretaq chiʼ kel ubʼi ri Jesus chilaʼ, naj kbʼe ubʼik pa ri utinimit ri Tiro e ri Sidon.	Aretaq chiʼ k>el u>bʼi ri Jesus chilaʼ, naj k>bʼe ubʼik pa ri u>tinimit ri Tiro e ri Sidon.
Pa oxqʼij ri Saʼn kbʼe na rukʼ ri ajkun.	Pa oxqʼij ri Saʼn k>bʼe na r>ukʼ ri ajkun.
Jas nu kʼu kuchʼobʼo	Jas nu kʼu k>u>chʼobʼ>o
Qʼän ri	Qʼän ri
we jastaq riʼ chi pa junalik.	we jastaq riʼ chi pa junalik.
jachike ri makaj rumal rech che man kixkojon ta chwech;	jachike ri makaj r>umal rech ch>e man k>ix>kojon ta ch>w>ech;
Chweʼq kujbʼe na pa ri jächʼ.	Chweʼq k>uj>bʼe na pa ri jächʼ.
Xojtzalijik xixeʼqaqʼatuj	X>oj>tzalij>ik x>ix>eʼ>qa>qʼatuj
Are waʼ we jastaq riʼ kemayow rukʼ ri man junam ta qakojonik kukʼ.	Are waʼ we jastaq riʼ k>e>mayow r>ukʼ ri man junam ta qa>kojonik k>ukʼ. 
Ri achi kbʼek pa utuj juyubʼ.	Ri achi k>bʼe>k pa u>tuj juyubʼ.
Xuqʼiʼo na xatatin taj	X>u>qʼiʼ>o na x>at>atin taj
33. Jun chomanik chik chi rajawixik keʼtzijon pa uwiʼ konojel taq ri	33. Jun chomanik chik chi rajawixik k>eʼ>tzijon pa u>wiʼ k>onojel taq ri
Tin Chuta, ubʼiʼ ri tataʼ.	Tin Chuta, u>bʼiʼ ri tataʼ.
Ri sipanik e ri nimalaj utzil chiwech ri ix, rumal ri Dyos Qatat e ri Ajawxel Jesus Kristo.	Ri sipanik e ri nimalaj utzil ch>iw>ech ri ix, r>umal ri Dyos Qa>tat e ri Ajawxel Jesus Kristo.
Nabʼe taqanik (1).	Nabʼe taqanik (1).
Rumal rech che jawiʼ kʼo wi ri jeʼlik imebʼil, xoqujeʼ chilaʼ riʼ kʼo wi ri iwanimaʼ».	R>umal rech ch>e jawiʼ kʼo wi ri jeʼl>ik i>mebʼil, xoqujeʼ chilaʼ riʼ kʼo wi ri iw>animaʼ».
Xineʼwaʼoq	X>in>eʼ>waʼ>oq
Matbʼinik	M>at>bʼin>ik
Utz iwech ix aretaq chiʼ kixyoqʼ rukʼ itzel taq tzij, aretaq chiʼ kixoqataxik, e aretaq chiʼ kbʼix na rukʼ tzijtal ronojel etzalal chiwech rumal wech ri in.	Utz iw>ech ix aretaq chiʼ k>ix>yoqʼ r>ukʼ itzel taq tzij, aretaq chiʼ k>ix>oqata>x>ik, e aretaq chiʼ k>bʼix na r>ukʼ tzijtal r>onojel etzalal ch>iw>ech r>umal w>ech ri in.
Are ri ali xojilow kanoq	Are ri ali x>oj>il>ow kanoq
Kinmeson na.	K>in>meson na.
kʼisbʼal junabʼ kʼolik	kʼisbʼal junabʼ kʼol>ik
Kabʼlajuj Noʼj ubʼiʼ we qʼij kamik.	Kabʼlajuj Noʼj u>bʼiʼ we qʼij kamik.
Kʼax ukemik le pas awumal	Kʼax u>kem>ik le pas aw>umal
¿La katkojon chkech ri eqʼaxal utzij ri Dyos, ajawinel Agripa? Ri in, wetaʼm che ri at katkojon chkech ri eʼareʼ».	¿La k>at>kojon ch>k>ech ri e>qʼaxal u>tzij ri Dyos, ajawinel Agripa? Ri in, w>etaʼm ch>e ri at k>at>kojon ch>k>ech ri eʼareʼ».
Jawi xkibʼij wi chi keʼe wi?	Jawi x>ki>bʼi>j wi chi k>e>ʼe wi?
xane rumal ri areʼ sibʼalaj eʼajjudiʼo kebʼe ubʼik e kekojon chrech ri Jesus.	xane r>umal ri areʼ sibʼalaj eʼ>ajjudiʼo k>e>bʼe ubʼik e k>e>kojon ch>r>ech ri Jesus.
Nabʼe xatopanik.	Nabʼe x>at>opan>ik.
Chkixoʼl ri efariseʼo, kʼo jun achi, Nikodemo ri ubʼiʼ, jun nimalaj winaq kech ri eʼajjudiʼo.	Ch>ki>xoʼl ri e>fariseʼo, kʼo jun achi, Nikodemo ri u>bʼiʼ, jun nimalaj winaq k>ech ri eʼ>ajjudiʼo.
Ri achi man rukʼ ta ri ixoq elenaq wi, xaneʼ are elenaq ri ixoq rukʼ ri achi;	Ri achi man r>ukʼ ta ri ixoq elenaq wi, xaneʼ are elenaq ri ixoq r>ukʼ ri achi;
Jeʼ, tajin kachaponik	Jeʼ, tajin ka>chapon>ik
Xanimaj bʼik ri kuk.	X>animaj bʼi>k ri kuk.
Xinpetik, na xinwil taj	X>in>pet>ik, na x>inw>il taj
Xäq xu wi waʼ kinkowin chech ubʼixik chi we.	Xäq xu wi waʼ k>in>kowin ch>ech u>bʼixik chi we.
Juwinaq oxlajuj qʼataj.	Juwinaq oxlajuj qʼataj.
rumal ri sukʼil, ri noʼjibʼal, ri kochʼonik, ri utzilal pa ri Tyoxlaj Uxlabʼaxel, pa ri qastzij loqʼoqʼebʼal kʼuʼx,	r>umal ri sukʼil, ri noʼjibʼal, ri kochʼonik, ri utzilal pa ri Tyoxlaj Uxlabʼaxel, pa ri qastzij loqʼoqʼebʼal kʼuʼx,
Rumal kʼuwaʼ weriʼ, ri utzij ri Ajawxel kkʼiyik e kʼo sibʼalaj uchuqʼabʼ.	R>umal kʼuwaʼ weriʼ, ri u>tzij ri Ajawxel k>kʼiy>ik e kʼo sibʼalaj u>chuqʼabʼ.
Kʼatekʼut, we areʼ, qetaʼm jawijeʼ kel wi, kʼatekʼuriʼ, ri Kristo, aretaq chiʼ kpetik, man kʼo ta jun winaq riʼ retaʼm jawijeʼ kel wi».	Kʼatekʼut, we areʼ, q>etaʼm jawijeʼ k>el wi, kʼatekʼuriʼ, ri Kristo, aretaq chiʼ k>pet>ik, man kʼo ta jun winaq riʼ r>etaʼm jawijeʼ k>el wi».
rumal rech che ri Dyos man jun Dyos taj rech chʼoʼj, xaneʼ Dyos rech ri jaʼmaril, jacha pa ronojel taq Komon Tyox kech ri eʼutz taq winaq.	r>umal rech ch>e ri Dyos man jun Dyos taj rech chʼoʼj, xaneʼ Dyos rech ri jaʼmaril, jacha pa r>onojel taq Komon Tyox k>ech ri eʼ>utz taq winaq.
Are le ukemik pas xretaʼmaj	Are le u>kem>ik pas x>r>etaʼma>j
Ri unan utat ronojel junabʼ kebʼe pa Jerusalem rumal ri nimaqʼij rech ri Qʼaxebʼal (Paskuʼa).	Ri u>nan u>tat r>onojel junabʼ k>e>bʼe pa Jerusalem r>umal ri nimaqʼij rech ri Qʼaxebʼal (Paskuʼa).
Xojkilo	X>oj>k>il>o
Kinchaʼ uwach le kinäqʼ.	K>in>chaʼ u>wach le kinäqʼ.
Jachin xatqʼalunik?	Jachin x>at>qʼalu>n>ik?
Jachin xtzaqow rech?	Jachin x>tzaq>ow r>ech?
Kʼatekʼuriʼ, man are ta ri uxlabʼal ri kpe nabʼe, xane are nabʼe kpe ri ukʼaslemal ri bʼaqilal chuwachulew, kʼatekʼuriʼ pa ukabʼ kpe ri uxlabʼal.	Kʼatekʼuriʼ, man are ta ri uxlabʼal ri k>pe nabʼe, xane are nabʼe k>pe ri u>kʼaslemal ri bʼaqilal ch>uwachulew, kʼatekʼuriʼ pa ukabʼ k>pe ri uxlabʼal.
Kʼo chʼumil chi uwach ri kaj.	Kʼo chʼumil chi u>wach ri kaj.
Pa ri Areʼ, ri uj kʼo ri qakolotajem rumal ri ukikʼel, kʼo ri sachibʼal makaj pa ri nimalaj usipanik,	Pa ri Areʼ, ri uj kʼo ri qa>kolotajem r>umal ri u>kikʼel, kʼo ri sachibʼal makaj pa ri nimalaj u>sipanik,
Rumal rech, che ri ukʼisbʼalil ri Pixabʼ, are ri Kristo, arech che ri kekojonik kkʼojiʼ ri kisukʼil.	R>umal rech, ch>e ri u>kʼisbʼalil ri Pixabʼ, are ri Kristo, arech ch>e ri k>e>kojon>ik k>kʼojiʼ ri ki>sukʼil.
Ri kʼäj rech kaxlaʼn wa.	Ri kʼäj rech kaxlaʼn wa.
Kʼatekʼuriʼ, ri Jesus kbʼe ubʼi puwiʼ ri juyubʼ Olivo.	Kʼatekʼuriʼ, ri Jesus k>bʼe u>bʼi p>u>wiʼ ri juyubʼ Olivo.
¡E sibʼalaj utz rech ri winaq che man ktzaq ta wumal ri in!».	¡E sibʼalaj utz rech ri winaq ch>e man k>tzaq ta w>umal ri in!».
Kʼo jupuq chij chi uxeʼ ri cheʼ.	Kʼo jupuq chij chi u>xeʼ ri cheʼ.
Qʼeqqʼoj rij ri amaʼ kej.	Qʼeqqʼoj r>ij ri amaʼ kej.
Aretaq chiʼ kqaj ri qʼij, kkʼojiʼ cho ri mexa kukʼ ri ekabʼlajuj.	Aretaq chiʼ k>qaj ri qʼij, k>kʼojiʼ cho ri mexa k>ukʼ ri e>kabʼlajuj.
Jun chi wi ri nuchak.	Jun chi wi ri nu>chak.
Xep Ajpop ubʼiʼ ri tataʼ.	Xep Ajpop u>bʼiʼ ri tataʼ.
Ri areʼ ukʼaxkʼolim chik kukʼ ekʼi eʼajkunanelabʼ. Ri areʼ usachom chik ronojel ri upwaq, kʼatekʼuriʼ, man kʼo ta kutzirik. Xa neʼ nimatajinaq.	Ri areʼ u>kʼaxkʼolim chik k>ukʼ ekʼi eʼ>ajkunanel>abʼ. Ri areʼ u>sachom chik r>onojel ri u>pwaq, kʼatekʼuriʼ, man kʼo ta k>utzirik. Xa neʼ nimatajinaq.
Jas karaj kaʼan	Jas ka>r>aj k>a>ʼan
ri usukʼil ri Dyos are ri kojonik chrech ri Jesus Kristo, chkech konojel ri eʼareʼ che kekojonik –rumal rech che man kʼo ta jalajoj chqaxoʼl.	ri u>sukʼil ri Dyos are ri kojonik ch>r>ech ri Jesus Kristo, ch>k>ech k>onojel ri eʼareʼ ch>e k>e>kojon>ik –r>umal rech ch>e man kʼo ta jalajoj ch>qa>xoʼl.
Are chixchoman chrech ri jastaq che rech chikaj, mixchoman chrech ri jastaq che rech ri uwachulew,	Are ch>ix>choman ch>r>ech ri jastaq ch>e rech chikaj, m>ix>choman ch>r>ech ri jastaq ch>e rech ri uwachulew,
Kinxikʼikʼik xinqʼaxik	K>in>xikʼikʼ>ik x>in>qʼax>ik
«Chel bʼa ikʼuʼx chkech ri winaq, jeʼ jachaʼ kel ukʼuʼx ri atat chkech ri winaq.	«Ch>el bʼa i>kʼuʼx ch>k>ech ri winaq, jeʼ jachaʼ k>el u>kʼuʼx ri a>tat ch>k>ech ri winaq.
Kawaj na katʼe taj	Ka>w>aj na k>at>ʼe taj
Xineʼbʼinoq	X>in>eʼ>bʼin>oq
Xujchap nukkunaxik	X>uj>chap nuk>kuna>x>ik
Teʼk Ixchobʼ ubʼiʼ ri nutat.	Teʼk Ixchobʼ u>bʼiʼ ri nu>tat.
Xinxiʼj wibʼ xinchʼawik	X>in>xiʼj w>ibʼ x>in>chʼaw>ik
Konojel ri siwantinamit ekʼo ukoq chuchiʼ ri ja.	K>onojel ri siwantinamit ekʼo uk>oq ch>u>chiʼ ri ja.
Xepe le winaq xolkikʼamaʼ	X>e>pe le winaq x>ol>ki>kʼam>aʼ
Xinwetaʼmaj chi na katpe taj	X>inw>etaʼma>j chi na k>at>pe taj
kixoʼl.	ki>xoʼl.
Xeʼok ri pokʼ pa ri umexa ri Poʼx.	X>eʼ>ok ri pokʼ pa ri u>mexa ri Poʼx.
Ukabʼ ukakʼal taqanik (22).	Ukabʼ ukakʼal taqanik (22).
Pa ri urox qʼij chi apanoq, kʼo jun kʼulanem pa ri Kana che jun utinimit ri Galileʼa, kʼatekʼuriʼ kʼo ri unan ri Jesus chilaʼ.	Pa ri urox qʼij chi apan>oq, kʼo jun kʼulanem pa ri Kana ch>e jun u>tinimit ri Galileʼa, kʼatekʼuriʼ kʼo ri u>nan ri Jesus chilaʼ.
«Kʼo jun achi che ekʼo kebʼ achijabʼ kʼo kikʼas rukʼ ri areʼ, ri nabʼe jobʼ okʼal denariʼos ri ukʼas, ri jun chik kawinaq lajuj.	«Kʼo jun achi ch>e ekʼo kebʼ achij>abʼ kʼo ki>kʼas r>ukʼ ri areʼ, ri nabʼe jobʼ okʼal denariʼo>s ri u>kʼas, ri jun chik kawinaq lajuj.
kʼatekʼuriʼ, man kʼo ta kichuqʼabʼ chuwach ri unoʼjibʼal e chuwach ri ruxlabʼal ri areʼ.	kʼatekʼuriʼ, man kʼo ta ki>chuqʼabʼ ch>u>wach ri u>noʼjibʼal e ch>u>wach ri r>uxlabʼal ri areʼ.
Luʼs ubʼiʼ ri recham.	Luʼs u>bʼiʼ ri r>echam.
Kajilil ri bʼe.	Ka>jilil ri bʼe.
Are rintat xiʼlowik,	Are r>in>tat x>iʼl>ow>ik,
Kʼatekʼuriʼ, ri sibʼalaj nim chuwach ronojel weriʼ, are riʼ, che ri ix kʼo ri loqʼoqʼebʼal ikʼuʼx; rukʼ weriʼ, kʼo ronojel utzil.	Kʼatekʼuriʼ, ri sibʼalaj nim ch>u>wach r>onojel weriʼ, are riʼ, ch>e ri ix kʼo ri loqʼoqʼebʼal i>kʼuʼx; r>ukʼ weriʼ, kʼo r>onojel utzil.
Säq rij ri plamux.	Säq r>ij ri plamux.
Aretaq chiʼ ri ala kuta we tzij riʼ, kbʼisonik kbʼek rumal rech che ri areʼ kʼo sibʼalaj umebʼil.	Aretaq chiʼ ri ala kut>a we tzij riʼ, k>bʼison>ik k>bʼe>k r>umal rech ch>e ri areʼ kʼo sibʼalaj u>mebʼil.
Kʼatekʼuriʼ, kekanaj jujun taq ikʼ kukʼ ri etijoxelabʼ.	Kʼatekʼuriʼ, k>e>kanaj jujun taq ikʼ k>ukʼ ri e>tijoxel>abʼ.
Uwajxaqlajuj taqanik (18).	Uwajxaqlajuj taqanik (18).
Kʼatekʼuriʼ, wetaʼm, che we achi riʼ –pa ubʼaqil on man pa ubʼaqil taj, are ri Dyos retaʼm waʼ weriʼ–	Kʼatekʼuriʼ, w>etaʼm, ch>e we achi riʼ –pa u>bʼaqil on man pa u>bʼaqil taj, are ri Dyos r>etaʼm waʼ weriʼ–
uchomanik jachin kakʼamow bʼe ri ubʼixik kabʼanik jachin ri kok che	u>chomanik jachin ka>kʼamow bʼe ri u>bʼixik ka>bʼan>ik jachin ri k>ok ch>e
Chi uxeʼ ri mexa kʼo wi ri chʼo.	Chi u>xeʼ ri mexa kʼo wi ri chʼo.
Ri a Kel kʼo che ajpatan.	Ri a K>el kʼo ch>e ajpatan.
pa ri qʼatbʼaltzij xuqujeʼ.	pa ri qʼatbʼaltzij xuqujeʼ.
Na xinnabʼej ta chutasik qakʼolibʼal	Na x>in>nabʼej ta ch>u>tas>ik qa>kʼolibʼal
Arechiʼ xopan ri wajxaqibʼ qʼij kebʼek arech kpusik ri uwiʼ ukowil ubʼaqil ri alaj ala. Kʼatekʼuriʼ are kkaj che Sakariʼas ri ubʼiʼ areʼ kkojik, jeʼ jas ri ubʼiʼ ri utat.	Arechiʼ x>opan ri wajxaqibʼ qʼij k>e>bʼe>k arech k>pus>ik ri u>wiʼ u>kowil u>bʼaqil ri alaj ala. Kʼatekʼuriʼ are k>kaj ch>e Sakariʼas ri u>bʼiʼ areʼ k>kojik, jeʼ jas ri u>bʼiʼ ri u>tat.
Aretaq chiʼ kqaj ri qʼij, kkʼam ubʼi chrech konojel ri eyawabʼibʼ, xoqujeʼ ri winaq che echapom rumal ri itzel uxlabʼal.	Aretaq chiʼ k>qaj ri qʼij, k>kʼam u>bʼi ch>r>ech k>onojel ri e>yawabʼ>ibʼ, xoqujeʼ ri winaq ch>e e>chapom r>umal ri itzel uxlabʼal.
Na kikityoxij ta chi kan kiwa	Na ki>ki>tyoxi>j ta chi kan ki>wa
Kawinaq kabʼlajuj qʼataj.	Kawinaq kabʼlajuj qʼataj.
Ri ulaʼnem xa rumal rech ri ali kbʼanik.	Ri ulaʼnem xa r>umal rech ri ali k>bʼan>ik.
Xoqujeʼ ksikʼix ri Jesus kukʼ ri eʼutijoxelabʼ.	Xoqujeʼ k>sikʼix ri Jesus k>ukʼ ri eʼ>u>tijoxel>abʼ.
20-29 kijunabʼ	20-29 ki>junabʼ
Kʼatekʼut, ri uj kʼo ri qakojonik rukʼ ri jun uxlabʼal riʼ jeʼ jas ri tzʼibʼatalik: Ri in xinkojonik e rumal kʼuriʼ xinchʼawik, xoqujeʼ ri uj kujkojonik e rumal na kʼuriʼ kujchʼawik,	Kʼatekʼut, ri uj kʼo ri qa>kojonik r>ukʼ ri jun uxlabʼal riʼ jeʼ jas ri tzʼibʼatalik: Ri in x>in>kojon>ik e r>umal kʼuriʼ x>in>chʼaw>ik, xoqujeʼ ri uj k>uj>kojon>ik e r>umal na kʼuriʼ k>uj>chʼaw>ik,
chiwech ri ix, ri nimalaj utzil e nimalaj loqʼoqʼebʼal kʼuʼx.	ch>iw>ech ri ix, ri nimalaj utzil e nimalaj loqʼoqʼebʼal kʼuʼx.
Nimanel ri akʼal Xwan.	Nimanel ri akʼal Xwan.
Ponopik ri a Kuʼ.	Ponopik ri a Kuʼ.
xoqujeʼ bʼaʼ ri ix chixkiʼkot bʼaʼ e chixjaʼjatoq wukʼ ri in.	xoqujeʼ bʼaʼ ri ix ch>ix>kiʼkot bʼaʼ e ch>ix>jaʼjat>oq w>ukʼ ri in.
Ri achalal junam kiwach.	Ri achalal junam ki>wach.
Kʼatekʼuriʼ, man naj ta riʼ kibʼe wi, rumal rech che ri kimoxil kqʼalajisaxik riʼ chkiwach nimalaj konojel, jacha xqʼalajisaxik ri kimoxil ri ekebʼ kanoq riʼ.	Kʼatekʼuriʼ, man naj ta riʼ ki>bʼe wi, r>umal rech ch>e ri ki>moxil k>qʼalajisa>x>ik riʼ ch>ki>wach nimalaj k>onojel, jacha x>qʼalajisa>x>ik ri ki>moxil ri e>kebʼ kan>oq riʼ.
Ri jun che man retaʼm ta uwach ri Kʼojolxel xoqujeʼ man retaʼm ta uwach riʼ ri Tatxel. Ri jun che retaʼm uwach ri Kʼojolxel xoqujeʼ retaʼm uwach ri Tatxel.	Ri jun ch>e man r>etaʼm ta u>wach ri Kʼojolxel xoqujeʼ man r>etaʼm ta u>wach riʼ ri Tatxel. Ri jun ch>e r>etaʼm u>wach ri Kʼojolxel xoqujeʼ r>etaʼm u>wach ri Tatxel.
We tzij riʼ xbʼe utzijoxik pa ri Judeʼa e pa taq ri nikʼaj amaqʼ chik che naqaj ekʼo wi.	We tzij riʼ x>bʼe u>tzijoxik pa ri Judeʼa e pa taq ri nikʼaj amaqʼ chik ch>e naqaj ekʼo wi.
Uwaq taqanik (6).	Uwaq taqanik (6).
Pa ri umajibʼal, ri areʼ kʼo rukʼ ri Dyos.	Pa ri u>majibʼal, ri areʼ kʼo r>ukʼ ri Dyos.
Ix wachalal; man are ta kiwil ri uwach ri winaq che kʼo pa ri ikojonik chrij ri Ajawxel Jesus Kristo che nimalaj uqʼijil.	Ix w>achalal; man are ta ki>wil ri u>wach ri winaq ch>e kʼo pa ri i>kojonik ch>r>ij ri Ajawxel Jesus Kristo ch>e nimalaj u>qʼijil.
kabʼix ri qas are ukolomal, ubʼe chi ke ri winaq.	ka>bʼix ri qas are u>kolomal, u>bʼe chi k>e ri winaq.
Le ukemik le pas kʼax chawe	Le u>kem>ik le pas kʼax ch>aw>e
keʼpe chʼaqap.	k>eʼ>pe chʼaqap.
Kʼo chi wachiʼl chanim.	Kʼo chi w>achiʼl chanim.
Pilonel uchak, ri a Tun.	Pilonel u>chak, ri a Tun.
Ri ajtij, kyajon chi kech ri akʼalabʼ.	Ri ajtij, k>yajon chi k>ech ri akʼal>abʼ.
Jachin xawilo chi are xtijow	Jachin x>aw>il>o chi are x>tij>ow
Kʼatekʼut, aretaq chiʼ xopan ri kojonik, ri uj ma uj kʼo ta chi chuxeʼ jun ajtij chik.	Kʼatekʼut, aretaq chiʼ x>opan ri kojonik, ri uj ma uj kʼo ta chi ch>u>xeʼ jun ajtij chik.
E bʼa xincha che areʼ chiʼ xinbʼek.	E bʼa x>in>cha ch>e areʼ chiʼ x>in>bʼe>k.
Käq ubʼaqʼ le turaʼs.	Käq u>bʼaqʼ le turaʼs.
Saqʼor che ri uchak ri achi.	Saqʼor ch>e ri u>chak ri achi.
Ri ruq numiʼal xelaqʼaxik.	Ri r>uq nu>miʼal x>elaqʼa>x>ik.
Ajwaral ri tataʼ Kux.	Ajwaral ri tataʼ Kux.
Jas xkiyako xata?	Jas x>ki>yak>o x>a>ta?
Chbʼana oxibʼ tʼoytʼik che le kʼaj.	Ch>bʼan>a oxibʼ tʼoytʼik ch>e le kʼ>aj.
Je la leʼ ri nupwiʼ.	Je la leʼ ri nu>pwiʼ.
Kinchakunik rech kinwaʼik	K>in>chakun>ik r>ech k>in>waʼ>ik
«¿Su kawaj Jesus at ajnasaret? ¿La xatpetik arech kakʼis tzij paqawiʼ ri uj? Ri in wetaʼm, at jachin ri at, at ri tyoxlaj abʼantajik at rech ri Dyos».	«¿Su k>awaj Jesus at ajnasaret? ¿La x>at>pet>ik arech ka>kʼis tzij pa>qa>wiʼ ri uj? Ri in w>etaʼm, at jachin ri at, at ri tyoxlaj a>bʼantajik at rech ri Dyos».
arech ri ikojonik, kʼo ri utikbʼalil puwiʼ ri uchuqʼabʼ ri Dyos e man puwiʼ ta ri ketaʼmabʼal ri ewinaq.	arech ri i>kojonik, kʼo ri u>tikbʼalil p>u>wiʼ ri u>chuqʼabʼ ri Dyos e man p>u>wiʼ ta ri k>etaʼmabʼal ri e>winaq.
Kok pa ri Jeriko, kqʼax pa ri tinamit.	K>ok pa ri Jeriko, k>qʼax pa ri tinamit.
Ajxik chʼichʼ ri Luʼs.	Ajxik chʼichʼ ri Luʼs.
keʼpe chʼaqap jaʼ. Wa winaq waʼ konojel nimaq taq kinoʼj pa	k>eʼ>pe chʼaqap jaʼ. Wa winaq waʼ k>onojel nim>aq taq ki>noʼj pa
Luʼ ubʼiʼ ri wachalal.	Luʼ u>bʼiʼ ri w>achalal.
Kinchakunik rech katwaʼik	K>in>chakun>ik r>ech k>at>waʼ>ik
Ri areʼ, chi are nabʼe kʼo uloq chuwach ronojel e ronojel jastaq kʼo pa ri areʼ.	Ri areʼ, chi are nabʼe kʼo uloq ch>u>wach r>onojel e r>onojel jastaq kʼo pa ri areʼ.
Xinnaʼo chi xattʼuyeʼik	X>in>naʼ>o chi x>at>tʼuy>eʼ>ik
Ajkun ri nutat.	Ajkun ri nu>tat.
Kakaj le akʼalabʼ kewaʼik	Ka>k>aj le akʼalabʼ k>e>waʼ>ik
Natural taj	Natural taj
Weriʼ, xetaʼmaxik pa ronojel ri Joppe, e sibʼalaj ekʼi ri xekojon chrech ri Ajawxel.	Weriʼ, x>etaʼma>x>ik pa r>onojel ri Joppe, e sibʼalaj ekʼi ri x>e>kojon ch>r>ech ri Ajawxel.
Are nakʼut rajawaxik che are nabʼe kbʼix na ri Kʼakʼ Utzalaj Tzij chkech konojel ri taq tinimit.	Are nakʼut rajawaxik ch>e are nabʼe k>bʼix na ri Kʼakʼ Utzalaj Tzij ch>k>ech k>onojel ri taq tinimit.
Ix alkʼuwaʼlaxel chixniman chrech ri kitzij ri inan itat, pa ri Ajawxel; rumal che utz weriʼ.	Ix alkʼuwaʼlaxel ch>ix>niman ch>r>ech ri ki>tzij ri i>nan i>tat, pa ri Ajawxel; r>umal ch>e utz weriʼ.
Juwinaq wuqlajuj qʼataj.	Juwinaq wuqlajuj qʼataj.
Talom ri uchiʼ ja.	Talom ri u>chiʼ ja.
¡Chi waral wi rajawaxik jun uxlabʼal rukʼ noʼjibʼal! Ri wuqubʼ jolomaj are ri wuqubʼ juyubʼ jawiʼ tʼuyul wi ri jun ixoq. «Xoqujeʼ, weriʼ, ewuqubʼ ajawinel,	¡Chi waral wi rajawaxik jun uxlabʼal r>ukʼ noʼjibʼal! Ri wuqubʼ jolom>aj are ri wuqubʼ juyubʼ jawiʼ tʼuyul wi ri jun ixoq. «Xoqujeʼ, weriʼ, e>wuqubʼ ajawinel,
Xex ruxlabʼ ri rikil.	Xex r>uxlabʼ ri rikil.
Ri nimalaj usipanik ri Ajawxel Jesus Kristo; ri loqʼoqʼebʼal ukʼuʼx ri Dyos e ri ukʼaslemal ri Tyoxlaj Uxlabʼxel kkʼojiʼ bʼaʼ iwukʼ nimalaj iwonojel.	Ri nimalaj u>sipanik ri Ajawxel Jesus Kristo; ri loqʼoqʼebʼal u>kʼuʼx ri Dyos e ri u>kʼaslemal ri Tyoxlaj Uxlabʼxel k>kʼojiʼ bʼaʼ iw>ukʼ nimalaj iw>onojel.
Kʼatekʼuriʼ jun chkech ri ekabʼlajuj, ri kbʼix Judas Iskariʼote chrech, kbʼe kukʼ ri enimaʼq chuchqajawibʼ,	Kʼatekʼuriʼ jun ch>k>ech ri e>kabʼlajuj, ri k>bʼix Judas Iskariʼote ch>r>ech, k>bʼe k>ukʼ ri e>nim>aʼq chuchqajaw>ibʼ,
In ri in utzalaj ajyuqʼ; e ri in wetaʼm kiwach ri enuchij e ri enuchij ketaʼm nuwach ri in	In ri in utzalaj ajyuqʼ; e ri in w>etaʼm ki>wach ri e>nu>chij e ri e>nu>chij k>etaʼm nu>wach ri in
Kawaj kinbʼij	Ka>w>aj k>in>bʼij
Xinloqʼ ulo jun alanxax rech kaqatijo	X>in>loqʼ ulo jun alanxax r>ech ka>qa>tij>o
Ri Utzij ri Ajawxel sibʼalaj naj xel ubʼi pa ri itinamit, man xaq ta pa ri Masedoniʼa e pa ri Akaya, xane pa ronojel kʼolbʼal, xoqujeʼ ri ikojonik chrech ri Dyos, xa jekʼuriʼ ma rajawaxik taj che kujchʼaw puwiʼ ri areʼ.	Ri U>tzij ri Ajawxel sibʼalaj naj x>el u>bʼi pa ri i>tinamit, man xaq ta pa ri Masedoniʼa e pa ri Akaya, xane pa r>onojel kʼolbʼal, xoqujeʼ ri i>kojonik ch>r>ech ri Dyos, xa jekʼuriʼ ma rajawaxik taj ch>e k>uj>chʼaw p>u>wiʼ ri areʼ.
Ronojel jas uwach, sukʼ riʼ chkiwach ri esukʼ taq winaq. Kʼatekʼuriʼ, chkiwach riʼ ma esukʼ winaq taj, man kʼo ta jun jas uwach riʼ che sukʼ chkiwach. Xoqujeʼ na kʼuriʼ, man sukʼ ta riʼ ri kuxlabʼal e ri kichomabʼal.	R>onojel jas u>wach, sukʼ riʼ ch>ki>wach ri e>sukʼ taq winaq. Kʼatekʼuriʼ, ch>ki>wach riʼ ma e>sukʼ winaq taj, man kʼo ta jun jas u>wach riʼ ch>e sukʼ ch>ki>wach. Xoqujeʼ na kʼuriʼ, man sukʼ ta riʼ ri k>uxlabʼal e ri ki>chomabʼal.
Le ukemik le pas utz (chawe)	Le u>kem>ik le pas utz (ch>aw>e)
Chatbʼinoq	Ch>at>bʼin>oq
Kaqoyʼej na kixpe taj	Ka>q>oyʼe>j na k>ix>pe taj
Chi relaqʼaxik kinaqʼ xeutaqchiʼj wi	Chi r>elaqʼa>x>ik kinaqʼ x>e>u>taqchiʼ>j wi
Ekʼi riʼ, ri kebʼe na rukʼ ri itzel kikʼaslemal; e kumal ri eʼareʼ sibʼalaj kyoqʼ na riʼ ri ubʼe ri saqalajtzij.	Ekʼi riʼ, ri k>e>bʼe na r>ukʼ ri itzel ki>kʼaslemal; e k>umal ri eʼareʼ sibʼalaj k>yoqʼ na riʼ ri u>bʼe ri saqalajtzij.
Xa je kʼu waʼ, rajawaxik che chkixoʼl we achijabʼ riʼ, che xebʼin qukʼ ronojel taq qʼij aretaq chiʼ ri Ajawxel Jesus xkʼasiʼ chqaxoʼl,	Xa je kʼu waʼ, rajawaxik ch>e ch>ki>xoʼl we achij>abʼ riʼ, ch>e x>e>bʼin q>ukʼ r>onojel taq qʼij aretaq chiʼ ri Ajawxel Jesus x>kʼasiʼ ch>qa>xoʼl,
Ulejik wa tajin kuʼano	U>lej>ik wa tajin k>u>ʼan>o
Kkunan ri achi.	K>kunan ri achi.
ma kʼo ta taq kichuqʼabʼ taq ri qʼatbʼal taq tzij ri okʼowinaq pa ri	ma kʼo ta taq ki>chuqʼabʼ taq ri qʼatbʼal taq tzij ri okʼowinaq pa ri
Nabʼe ukakʼal taqanik (21).	Nabʼe ukakʼal taqanik (21).
?xinnaʼo chi xintakʼeʼik	?x>in>naʼ>o chi x>in>takʼ>eʼ>ik
Ri kaj man kʼo ta ukʼisik.	Ri kaj man kʼo ta u>kʼisik.
Rumal rech che ri uj, uj ajchakunelabʼ rech ri Dyos; e ri ix, ix rulew ri Dyos, ix, ri ix rachoch ri Dyos.	R>umal rech ch>e ri uj, uj ajchakunel>abʼ rech ri Dyos; e ri ix, ix r>ulew ri Dyos, ix, ri ix r>achoch ri Dyos.
Kʼatekʼuriʼ, we jun ixoq riʼ, are ri Nimalaj tinimit, che ktaqan pakiwiʼ ri eʼajawinel erech ri uwachulew».	Kʼatekʼuriʼ, we jun ixoq riʼ, are ri Nimalaj tinimit, ch>e k>taqan pa>ki>wiʼ ri eʼ>ajawinel e>r>ech ri uwachulew».
Le ukemik le pas aninaq (awumal)	Le u>kem>ik le pas aninaq (aw>umal)
Xoqujeʼ ri ix, che ojer kanoq ix kaxlan taq winaq e ixkʼulel, rumal ri itzel taq ichomanik e ri itzel taq ichak,	Xoqujeʼ ri ix, ch>e ojer kan>oq ix kaxlan taq winaq e ix>kʼulel, r>umal ri itzel taq i>chomanik e ri itzel taq i>chak,
Uwuq ukakʼal taqanik (27).	Uwuq ukakʼal taqanik (27).
Jas xutij  le ala xawilo?	Jas x>u>tij  le ala x>aw>il>o?
Jas nu kʼu kuchʼobʼ sin kanma...	Jas nu kʼu k>u>chʼobʼ sin k>anma...
Ajsik che ri tinamit kel wi ri tataʼ.	Ajsik ch>e ri tinamit k>el wi ri tataʼ.
Kʼo qʼol chi rij ri siʼ.	Kʼo qʼol chi r>ij ri siʼ.
E kʼo jobʼ chʼil wakʼ.	E kʼo jobʼ chʼil w>akʼ.
man kkiʼkot ta chuwach ri man sukʼ taj, are kkiʼkot chuwach ri saqalaj tzij.	man k>kiʼkot ta ch>u>wach ri man sukʼ taj, are k>kiʼkot ch>u>wach ri saqalaj tzij.
kʼatekʼuriʼ ri Ekomon Tyox pa ri Judeʼa rumal ri Kristo, man ketaʼm ta nuwach ri in;	kʼatekʼuriʼ ri E>komon Tyox pa ri Judeʼa r>umal ri Kristo, man k>etaʼm ta nu>wach ri in;
Kʼatekʼuriʼ xkʼojiʼ sibʼalaj kiʼkotemal pa we jun tinamit riʼ.	Kʼatekʼuriʼ x>kʼojiʼ sibʼalaj kiʼkotemal pa we jun tinamit riʼ.
Ronojel qʼij ktoj ri nuchak.	R>onojel qʼij k>toj ri nu>chak.
Kʼo kebʼ umul chi uwach ri tyox ja.	Kʼo kebʼ umul chi u>wach ri tyox ja.
kʼatekʼut, we eʼare riʼ man kʼo ta chi kichuqʼabʼ e man xkʼojiʼ ta chi kikʼolbʼal pa ri kaj.	kʼatekʼut, we eʼare riʼ man kʼo ta chi ki>chuqʼabʼ e man x>kʼojiʼ ta chi ki>kʼolbʼal pa ri kaj.
Kakimulij jusin kifondo	Ka>ki>muli>j ju>sin ki>fondo
Ix ixalkʼuwaʼlaxelabʼ, chixniman bʼaʼ pa ronojel chkech ri inan itat, waʼ weriʼ, utz pa ri Ajawxel.	Ix ix>alkʼuwaʼlaxel>abʼ, ch>ix>niman bʼaʼ pa r>onojel ch>k>ech ri i>nan i>tat, waʼ weriʼ, utz pa ri Ajawxel.
Chi chanim, aretaq chiʼ tajin kchʼaw na, kpe ri Judas, jun chkech ri ekabʼlajuj e epetinaq rukʼ areʼ juqʼat winaq rukʼ kichʼichʼ rech chʼoʼj e rukʼ taq cheʼ. Epetinaq uloq, rumal etaqom uloq kumal ri enim taq chuchqajawibʼ, ri eʼajtzʼibʼanelabʼ e ri enimaʼq taq winaq.	Chi chanim, aretaq chiʼ tajin k>chʼaw na, k>pe ri Judas, jun ch>k>ech ri e>kabʼlajuj e e>petinaq r>ukʼ areʼ juqʼat winaq r>ukʼ ki>chʼichʼ rech chʼoʼj e r>ukʼ taq cheʼ. E>petinaq uloq, r>umal e>taqom uloq k>umal ri e>nim taq chuchqajaw>ibʼ, ri eʼ>ajtzʼibʼanel>abʼ e ri e>nim>aʼq taq winaq.
Kʼatekʼuriʼ, rukʼ weriʼ, ri ix kixok na riʼ pa ri Junalik Rajawibʼal ri Qajawxel e Qakolonel Jesus Kristo.	Kʼatekʼuriʼ, r>ukʼ weriʼ, ri ix k>ix>ok na riʼ pa ri Junalik R>ajawibʼal ri Q>ajawxel e Qa>kolonel Jesus Kristo.
Ri etaqom uloq, ejujun taq fariseʼo.	Ri e>taqom uloq, e>jujun taq fariseʼo.
Konojel junam kanimaʼ kekanaj pa ri chʼawem rukʼ ri Dyos, ekʼo kukʼ ri eʼareʼ ejujun taq ixoqibʼ, kʼo ri Mariʼy ri unan ri Jesus, e ri erachalal.	K>onojel junam k>animaʼ k>e>kanaj pa ri chʼawem r>ukʼ ri Dyos, ekʼo k>ukʼ ri eʼareʼ e>jujun taq ixoq>ibʼ, kʼo ri Mariʼy ri u>nan ri Jesus, e ri e>r>achalal.
kʼatekʼuriʼ, ri eʼareʼ kamik riʼ man keniman taj, rumal rech che ri ix xsachatajik ri imak, arech ri eʼareʼ xoqujeʼ kamik riʼ ksachatajik ri kimak.	kʼatekʼuriʼ, ri eʼareʼ kamik riʼ man k>e>niman taj, r>umal rech ch>e ri ix x>sach>ataj>ik ri i>mak, arech ri eʼareʼ xoqujeʼ kamik riʼ k>sach>ataj>ik ri ki>mak.
Ri jun che petinaq uloq chikaj kʼo pakiwiʼ konojel; ri jun che kel pa ri uwachulew rech ri uwachulew e ktzijonik jeʼ jas jun che rech ri uwachulew. Ri jun che petinaq uloq chikaj	Ri jun ch>e petinaq uloq chikaj kʼo pa>ki>wiʼ k>onojel; ri jun ch>e k>el pa ri uwachulew rech ri uwachulew e k>tzijon>ik jeʼ jas jun ch>e rech ri uwachulew. Ri jun ch>e petinaq uloq chikaj
Kwaj na katʼe taj	K>w>aj na k>at>ʼe taj
re ri tinimit.	r>e ri tinimit.
Cha´tal ri ijaʼ xqatik iwir.	Cha´tal ri i>jaʼ x>qat>ik iwir.
Kaqatijo	Ka>qa>tij>o
rech kakʼex ri ubʼantajik ri tinimit.	rech ka>kʼex ri u>bʼantajik ri tinimit.
Aretaq chiʼ kqaj ri qʼij, kopan kukʼ ri ekabʼlajuj.	Aretaq chiʼ k>qaj ri qʼij, k>opan k>ukʼ ri e>kabʼlajuj.
Xas kʼateʼ pa taq we qʼij kamik riʼ; ronojel taq mul aretaq chiʼ ksikʼix uwach ri Moʼises, xas kʼo wi jun payuʼ pa taq ri kanimaʼ.	Xas kʼateʼ pa taq we qʼij kamik riʼ; r>onojel taq mul aretaq chiʼ k>sikʼix u>wach ri Moʼises, xas kʼo wi jun payuʼ pa taq ri k>animaʼ.
Xuta we katʼek	X>u>ta we k>at>ʼe>k
Waʼ we jun chomanik riʼ, man petinaq ta rukʼ ri Areʼ ri kixsikʼinik.	Waʼ we jun chomanik riʼ, man petinaq ta r>ukʼ ri Areʼ ri k>ix>sikʼin>ik.
Xwaʼik	X>waʼ>ik
Katpe je waʼ.	K>at>pe je waʼ.
¿Jas kʼut? ¿Ri uj, la kujmakun na riʼ, rumal che man uj kʼo ta chi chuxeʼ ri Pixabʼ, xane uj kʼo chuxeʼ ri Sipanik? ¡Man kujmakun ta chi riʼ!	¿Jas kʼut? ¿Ri uj, la k>uj>makun na riʼ, r>umal ch>e man uj kʼo ta chi ch>u>xeʼ ri Pixabʼ, xane uj kʼo ch>u>xeʼ ri Sipanik? ¡Man k>uj>makun ta chi riʼ!
Kawaj katʼek	Ka>w>aj k>at>ʼe>k
Chweʼq kujbʼeʼ pa muquj.	Chweʼq k>uj>bʼeʼ pa muquj.
¿La man rumal ta kʼuwaʼ weriʼ che ri ix kitoj ri alkabʼal? Rumal rech, che ekʼo eʼajpataninel kech ri tinimit, che kechakun rumal ri Dyos pa we chak riʼ.	¿La man r>umal ta kʼuwaʼ weriʼ ch>e ri ix ki>toj ri alkabʼal? R>umal rech, ch>e ekʼo eʼ>ajpataninel k>ech ri tinimit, ch>e k>e>chakun r>umal ri Dyos pa we chak riʼ.
Xataqchiʼj le akʼal chutijik kar	X>a>taqchiʼ>j le akʼal ch>u>tij>ik kar
Kʼatekʼut, aretaq chiʼ kpe na ri qas tzʼaqat, ksach na uwach riʼ ri xa jubʼiqʼ.	Kʼatekʼut, aretaq chiʼ k>pe na ri qas tzʼaqat, k>sach na u>wach riʼ ri xa jubʼiqʼ.
Weriʼ, utz rukʼ ri kitzij ri eqʼaxal utzij ri Dyos, rumal rech che tzʼibʼatalik:	Weriʼ, utz r>ukʼ ri ki>tzij ri e>qʼaxal u>tzij ri Dyos, r>umal rech ch>e tzʼibʼatalik:
Qas amaqʼel chixkiʼkotoq.	Qas amaqʼel ch>ix>kiʼkot>oq.
Ajitz ri Xep.	Ajitz ri Xep.
ri ma e kʼo ta qʼatbʼaltzij, ri qatol taq tzij pa uwiʼ kʼax. Ma kʼo taj	ri ma e kʼo ta qʼatbʼaltzij, ri qa>tol taq tzij pa u>wiʼ kʼax. Ma kʼo taj
?jas xkibʼij chi xkilo ?	?jas x>ki>bʼij chi x>k>il>o ?
Katakʼmaʼy ri wakʼ.	Ka>takʼmaʼy ri w>akʼ.
Rumal kʼu waʼ, chi pa ri utoqʼobʼ waʼ weriʼ, ri in kinkosik chi rukʼ ri uchuqʼabʼ ri Kristo che xas kchakun wi wukʼ ri in.	R>umal kʼu waʼ, chi pa ri u>toqʼobʼ waʼ weriʼ, ri in k>in>kos>ik chi r>ukʼ ri u>chuqʼabʼ ri Kristo ch>e xas k>chakun wi w>ukʼ ri in.
Kʼatekʼuriʼ ri eʼareʼ keʼopan pa ri Antiʼokiʼa che rulew ri Pisidiʼa. Pa ri qʼij Sabʼado keʼok pa ri sinagoga e ketʼuyiʼk.	Kʼatekʼuriʼ ri eʼareʼ k>eʼ>opan pa ri Antiʼokiʼa ch>e r>ulew ri Pisidiʼa. Pa ri qʼij Sabʼado k>eʼ>ok pa ri sinagoga e k>e>tʼuyiʼ>k.
E kʼo ri eloqʼomanel.	E kʼo ri e>loqʼomanel.
Kamik riʼ kʼaslik ri kojonik, ri eyeʼbʼal e ri loqʼoqʼebʼal kʼuʼx, are wa we oxibʼ jastaq riʼ, kʼatekʼut ri nim chuxoʼl we oxibʼ riʼ, are ri loqʼoqʼebʼal kʼuʼx.	Kamik riʼ kʼaslik ri kojonik, ri eyeʼbʼal e ri loqʼoqʼebʼal kʼuʼx, are wa we oxibʼ jastaq riʼ, kʼatekʼut ri nim ch>u>xoʼl we oxibʼ riʼ, are ri loqʼoqʼebʼal kʼuʼx.
La kawaj kʼut katʼek?	La k>aw>aj kʼut k>at>ʼe>k?
Xäq katchʼoknaj iwir.	Xäq k>at>chʼoknaj iwir.
¡Ri Ajawxel kkʼojiʼ bʼaʼ rukʼ ri awuxlabʼal! ¡Ri usipanik ri Dyos kkʼojiʼ bʼaʼ iwukʼ ri ix!	¡Ri Ajawxel k>kʼojiʼ bʼaʼ r>ukʼ ri aw>uxlabʼal! ¡Ri u>sipanik ri Dyos k>kʼojiʼ bʼaʼ iw>ukʼ ri ix!
Xkʼis ri nusiʼ.	X>kʼis ri nu>siʼ.
Rumal rech, che ri areʼ, xilitaj ri usukʼil che are nim chi na uqʼijil chuwach ri uqʼijil ri Moʼises; rumal rech, che ri nimalaj ubʼantajik ri ajbʼanal ja, xas are nimalaj ubʼantajik chi na chuwach ri nimalaj ubʼantajik ri jun ja.	R>umal rech, ch>e ri areʼ, x>ilitaj ri u>sukʼil ch>e are nim chi na u>qʼijil ch>u>wach ri u>qʼijil ri Moʼises; r>umal rech, ch>e ri nimalaj u>bʼantajik ri ajbʼanal ja, xas are nimalaj u>bʼantajik chi na ch>u>wach ri nimalaj u>bʼantajik ri jun ja.
Jas utzakik le subʼ xuʼano?	Jas u>tzak>ik le subʼ x>u>ʼan>o?
Kʼatekʼuriʼ, ri kʼolbʼal jawijeʼ kinbʼe wi ri in, ri ix iwetaʼm ri bʼe».	Kʼatekʼuriʼ, ri kʼolbʼal jawijeʼ k>in>bʼe wi ri in, ri ix iw>etaʼm ri bʼe».
ubʼixik che ri ubʼixik jachin ri qʼatbʼaltzij ri rajawixik kokik, rech kilixik	u>bʼixik ch>e ri u>bʼixik jachin ri qʼatbʼaltzij ri rajawixik k>ok>ik, rech k>ili>x>ik
xoqujeʼ ri uj, uj xa jun chi bʼaqilal pa ri Kristo Jesus, e qonojel chi utzʼaqatil ri bʼaqilal, uj kitzaqatil chkijujunal ri enikʼaj chik.	xoqujeʼ ri uj, uj xa jun chi bʼaqilal pa ri Kristo Jesus, e q>onojel chi u>tzʼaqatil ri bʼaqilal, uj ki>tzaqatil chkijujunal ri e>nikʼaj chik.
Takʼal le akʼal chlaʼ rech kaqachʼabʼej	Takʼal le akʼal chlaʼ r>ech ka>qa>chʼabʼe>j
Ajqʼojom, ri nutat.	Ajqʼojom, ri nu>tat.
Kikunaxik akʼalabʼ xretaʼmaj	Ki>kuna>x>ik akʼal>abʼ x>r>etaʼma>j
Qʼän rij ri atiʼt nukej.	Qʼän r>ij ri atiʼt nu>kej.
rumal ri Saqalajtzij che kʼo qukʼ ri uj, e che kkanaj kan riʼ pa junalik qukʼ uj,	r>umal ri Saqalajtzij ch>e kʼo q>ukʼ ri uj, e ch>e k>kanaj kan riʼ pa junalik q>ukʼ uj,
pa le nima tinamit.	pa le nima tinamit.
Naʼl kayuj ri kinäqʼ rukʼ ri muchʼ.	Naʼl ka>yuj ri kinäqʼ r>ukʼ ri muchʼ.
Chiwech ri ix, ri usipanik e ri rutzil ri Dyos e ri Ajawxel Jesus Kristo.	Ch>iw>ech ri ix, ri u>sipanik e ri r>utzil ri Dyos e ri Ajawxel Jesus Kristo.
Chom ri usaqmoʼl ri patäx.	Chom ri u>saqmoʼl ri patäx.
waʼ chiʼ pa wa Iximulew.	waʼ chiʼ pa wa Iximulew.
Maltyox bʼaʼ chrech ri Dyos rumal ri nimalaj taq usipanik.	Maltyox bʼaʼ ch>r>ech ri Dyos r>umal ri nimalaj taq u>sipanik.
jun kʼakʼ laj tinimit chech.	jun kʼakʼ laj tinimit ch>ech.
Ri Luʼs Yaxon kʼo oxibʼ uwakäx nimaʼq.	Ri Luʼs Yaxon kʼo oxibʼ u>wakäx nim>aʼq.
Xojutaqchiʼij xojʼek	X>oj>u>taqchiʼi>j x>oj>ʼe>k
Jawi kawaj katwaʼ  wi	Jawi k>aw>aj k>at>waʼ  wi
Juwinaq julajuj:	Juwinaq julajuj:
Kmatzatz kbʼin ri alaj tzʼiʼ.	K>matzatz k>bʼin ri alaj tzʼiʼ.
Xuta jachin kaʼek	X>u>ta jachin ka>ʼe>k
Ri kamisanel kʼo pa cheʼ. 2% 	Ri kamisanel kʼo pa cheʼ. 2% 
chrech ri Tito, ri qastzij walkʼuwaʼl pa ri komon qakojonik, chech ri areʼ, ri usipanik e ri nimalaj rutzilal ri Dyos Tatxel e xoqujeʼ ri rutzilal ri Jesus Kristo ri Qakolonel.	ch>r>ech ri Tito, ri qastzij w>alkʼuwaʼl pa ri komon qa>kojonik, ch>ech ri areʼ, ri u>sipanik e ri nimalaj r>utzilal ri Dyos Tatxel e xoqujeʼ ri r>utzilal ri Jesus Kristo ri Qa>kolonel.
Katchʼaw chi rij awachalal.	K>at>chʼaw chi r>ij aw>achalal.
utz bʼaʼ chbʼe ri ikʼaslemal pa we uwachulew riʼ, rumal rech che itzel taq we qʼij riʼ;	utz bʼaʼ ch>bʼe ri i>kʼaslemal pa we uwachulew riʼ, r>umal rech ch>e itzel taq we qʼij riʼ;
Ri ix, ix qʼataltzij chwech ri in, che xas in xinbʼinik: “Man in taj ri Kristo, ri in, are intaqom uloq chuwach ri areʼ”.	Ri ix, ix qʼataltzij ch>w>ech ri in, ch>e xas in x>in>bʼin>ik: “Man in taj ri Kristo, ri in, are in>taqom uloq ch>u>wach ri areʼ”.
e ri uj kujkanaj kan waʼ chuwach ri chʼawem rukʼ ri Dyos e chrech ri upatanaxik ri Tzij».	e ri uj k>uj>kanaj kan waʼ ch>u>wach ri chʼawem r>ukʼ ri Dyos e ch>r>ech ri u>patanaxik ri Tzij».
Are waʼ weriʼ, ri qas utz chuwach ri Dyos Qajawxel e jewaʼ ri qas urayibʼal ri areʼ.	Are waʼ weriʼ, ri qas utz ch>u>wach ri Dyos Q>ajawxel e jewaʼ ri qas u>rayibʼal ri areʼ.
Ri kaj e ri uwachulew xa qʼaxel, e kʼu ri nutzij man qʼaxel taj.	Ri kaj e ri uwachulew xa qʼaxel, e kʼu ri nu>tzij man qʼaxel taj.
Jeʼ chweʼq kinbʼek jelaʼ.	Jeʼ chweʼq k>in>bʼe>k jelaʼ.
Kʼax le nuqʼabʼ	Kʼax le nu>qʼabʼ
Jeʼl ri qʼij kamik.	Jeʼl ri qʼij kamik.
Kʼatekʼuriʼ, ri nimalaj rutzil ri Dyos che are nim chuwach ronojel noʼjibʼal, are areʼ riʼ ri kchajin na ri iwanimaʼ e ri ichomanik pa ri Kristo Jesus.	Kʼatekʼuriʼ, ri nimalaj r>utzil ri Dyos ch>e are nim ch>u>wach r>onojel noʼjibʼal, are areʼ riʼ ri k>chajin na ri iw>animaʼ e ri i>chomanik pa ri Kristo Jesus.
- ¡Ay!  Xa xintzaq uloq, kʼax we waqan. 	- ¡Ay!  Xa x>in>tzaq uloq, kʼax we w>aqan. 
Aretaq chiʼ ri Jesus kbʼe chi jumul chʼaqap che ri polow, sibʼalaj winaq kepe rukʼ ri areʼ, ri areʼ kʼo chuchiʼ ri polow.	Aretaq chiʼ ri Jesus k>bʼe chi jumul chʼaqap ch>e ri polow, sibʼalaj winaq k>e>pe r>ukʼ ri areʼ, ri areʼ kʼo ch>u>chiʼ ri polow.
Miqʼin ri lej.	Miqʼin ri lej.
Jas xurayij le anan xutijo ?	Jas x>u>rayi>j le a>nan x>u>tij>o ?
Xsikir le waqan.	X>sikir le w>aqan.
Kʼatekʼuriʼ, kʼo jun chuchqajaw ajawinel, kʼamal bʼe pa ri Rachoch ri Dyos.	Kʼatekʼuriʼ, kʼo jun chuchqajaw ajawinel, kʼamal bʼe pa ri R>achoch ri Dyos.
Xinloqʼ ulo jun wuj	X>in>loqʼ ulo jun wuj
Kʼax rilik le akʼal chawe	Kʼax r>il>ik le akʼal ch>aw>e
Ri Felipe Ajbʼetsaʼida; ri tinimit pa ri keʼel wi ri Atrix e ri Pedro.	Ri Felipe Ajbʼetsaʼida; ri tinimit pa ri k>eʼ>el wi ri Atrix e ri Pedro.
Kawinaq jun qʼataj.	Kawinaq jun qʼataj.
Pakʼalik ri a Kuʼ chi uwach ri qʼij.	Pakʼalik ri a Kuʼ chi u>wach ri qʼij.
Qʼeʼlik, ri chäj pa ri bʼe.	Qʼeʼlik, ri chäj pa ri bʼe.
Xa jekʼuriʼ, rukʼ weriʼ, utz chnuwach ri in we kinkanaj kan iwukʼ iwonojel arech kkʼiyik ri ikojonik e ri ekiʼkotemal	Xa jekʼuriʼ, r>ukʼ weriʼ, utz ch>nu>wach ri in we k>in>kanaj kan iw>ukʼ iw>onojel arech k>kʼiy>ik ri i>kojonik e ri e>kiʼkotemal
Ri Tito, ri areʼ wachiʼl ri in e wajchak chixoʼl ri ix; ri enikʼaj chik, eʼareʼ ri eʼachalaxik che etaqom ubʼik chkech ri Ekomon Tyox: Eʼare uqʼijil ri Kristo.	Ri Tito, ri areʼ w>achiʼl ri in e w>ajchak ch>i>xoʼl ri ix; ri e>nikʼaj chik, eʼareʼ ri eʼ>achalaxik ch>e e>taqom ubʼik ch>k>ech ri E>komon Tyox: Eʼare u>qʼijil ri Kristo.
Kʼatekʼuriʼ, we kʼo waʼ we qeyeʼbʼal riʼ, sibʼalaj kʼo qachuqʼabʼ riʼ pa ri qakʼaslemal,	Kʼatekʼuriʼ, we kʼo waʼ we q>eyeʼbʼal riʼ, sibʼalaj kʼo qa>chuqʼabʼ riʼ pa ri qa>kʼaslemal,
Ri kaj, ri uwachulew ksach na uwach riʼ, kʼatekʼut ri nutzij man ksach ta uwach riʼ.	Ri kaj, ri uwachulew k>sach na u>wach riʼ, kʼatekʼut ri nu>tzij man k>sach ta u>wach riʼ.
Rumal che jawijeʼ kʼo wi ri aqʼinomal, xoqujeʼ chilaʼ riʼ kʼo wiʼ ri awanimaʼ.	R>umal ch>e jawijeʼ kʼo wi ri a>qʼinomal, xoqujeʼ chilaʼ riʼ kʼo wiʼ ri aw>animaʼ.
Ri nuxajabʼ kacharanik.	Ri nu>xajabʼ ka>charan>ik.
Amaqʼ	Amaqʼ
rumal rech, che ri uj kqaj ri utzil chuwach ri Dyos e xoqujeʼ chkiwach ri winaq.	r>umal rech, ch>e ri uj k>qaj ri utzil ch>u>wach ri Dyos e xoqujeʼ ch>ki>wach ri winaq.
Ri areʼ kʼo pa ri uwachulew, e ri uwachulew xbʼantajik rumal ri areʼ, kʼatekʼuriʼ ri uwachulew man retaʼm ta uwach ri areʼ.	Ri areʼ kʼo pa ri uwachulew, e ri uwachulew x>bʼan>taj>ik r>umal ri areʼ, kʼatekʼuriʼ ri uwachulew man r>etaʼm ta u>wach ri areʼ.
UvA.	UvA.
Ri qʼayes kjaʼjat uwach.	Ri qʼayes k>jaʼjat u>wach.
Xqaj chi rij ri achi ri kaqulja.	X>qaj chi r>ij ri achi ri kaqulja.
Ekʼo apan chilaʼ jumulaj jupuq taq aq che tajin kewaʼkat apanoq.	Ekʼo apan chilaʼ jumulaj jupuq taq aq ch>e tajin k>e>waʼkat apan>oq.
Kʼatekʼuriʼ, ri Jesus, kbʼe chʼaqap chrech ri polow Galileʼa, on chrech ri Tibʼeriʼades.	Kʼatekʼuriʼ, ri Jesus, k>bʼe chʼaqap ch>r>ech ri polow Galileʼa, on ch>r>ech ri Tibʼeriʼades.
Ri Jesus kʼax ktaqan chrech ri Itzel, e kel ubʼi rukʼ ri ala, e chi utz kkanaj uloq ri ala riʼ.	Ri Jesus kʼax k>taqan ch>r>ech ri Itzel, e k>el u>bʼi r>ukʼ ri ala, e chi utz k>kanaj uloq ri ala riʼ.
ri tijonik puwiʼ ri qasnaʼ e ri ukojik ri qʼabʼaj cho ri jolomaj, ri kʼastajibʼal kech ri kaminaqibʼ e ri junalik qʼatbʼaltzij.	ri tijonik p>u>wiʼ ri qasnaʼ e ri u>kojik ri qʼabʼ>aj cho ri jolom>aj, ri kʼastajibʼal k>ech ri kaminaq>ibʼ e ri junalik qʼatbʼaltzij.
Jeriʼ nakʼut, tolonik kkanaj na kan ri iwachoch.	Jeriʼ nakʼut, tolonik k>kanaj na kan ri iw>achoch.
Utz iwech ri ix ri kixnumik kamik riʼ, rumal che sibʼalaj kixwaʼ na riʼ. Utz iwech ri ix ri kixoqʼik kamik riʼ, rumal che kixjaʼjatik na riʼ.	Utz iw>ech ri ix ri k>ix>num>ik kamik riʼ, r>umal ch>e sibʼalaj k>ix>waʼ na riʼ. Utz iw>ech ri ix ri k>ix>oqʼ>ik kamik riʼ, r>umal ch>e k>ix>jaʼjat>ik na riʼ.
kichak.	ki>chak.
Awumal	Aw>umal
We kʼo jun ktuqaʼrik, ¿la man xoqujeʼ taj kintuqaʼr ri in? We kʼo jun ktzaqik ¿la man kinporoj ta wibʼ ri in?	We kʼo jun k>tuqaʼr>ik, ¿la man xoqujeʼ taj k>in>tuqaʼr ri in? We kʼo jun k>tzaq>ik ¿la man k>in>poroj ta w>ibʼ ri in?
Qas chixchʼaw rukʼ ri Dyos pa ronojel kajbʼal.	Qas ch>ix>chʼaw r>ukʼ ri Dyos pa r>onojel kajbʼal.
Ri ix, man xixqibʼ ta rukʼ jun jas uwach che kilitaj uwach: che qʼaqʼ, che qʼequʼmal, che nimalaj qʼequʼm; nimalaj kaqiqʼ,	Ri ix, man x>ix>qibʼ ta r>ukʼ jun jas u>wach ch>e k>ilitaj u>wach: ch>e qʼaqʼ, ch>e qʼequʼmal, ch>e nimalaj qʼequʼm; nimalaj kaqiqʼ,
Ri axux are na ri ukunel ri kinäqʼ.	Ri axux are na ri u>kunel ri kinäqʼ.
Aretaq chiʼ keʼel ubʼi ri efariseʼo kechʼaw chkiwach chrij ri areʼ, arech are kkaj kkichup uwach ri areʼ.	Aretaq chiʼ k>eʼ>el u>bʼi ri e>fariseʼo k>e>chʼaw ch>ki>wach ch>r>ij ri areʼ, arech are k>kaj k>ki>chup u>wach ri areʼ.
«Kʼatekʼuriʼ, ri in, xinbʼe pa ri Damasko, rukʼ ronojel kowinem e rukʼ kitaqanik ri enim chuchqajawibʼ.	«Kʼatekʼuriʼ, ri in, x>in>bʼe pa ri Damasko, r>ukʼ r>onojel kowinem e r>ukʼ ki>taqanik ri e>nim chuchqajaw>ibʼ.
Ri nuchak are qʼaxel tzij.	Ri nu>chak are qʼaxel tzij.
Ri qʼutuʼm man kech ta le akʼalabʼ.	Ri qʼutuʼm man k>ech ta le akʼal>abʼ.
Xretaʼmaj uchʼajik	X>r>etaʼmaj u>chʼaj>ik
E ri eʼareʼ ketzalij uloq che ubʼixik weriʼ chkech ri e nikʼaj chik, e xoqujeʼ man kekojon ta chkech ri eʼareʼ.	E ri eʼareʼ k>e>tzalij uloq ch>e u>bʼixik weriʼ ch>k>ech ri e nikʼaj chik, e xoqujeʼ man k>e>kojon ta ch>k>ech ri eʼareʼ.
pa kʼax rumal chi xa su jeʼ waʼ pa ronojel wa uwa ulew, xuqujeʼ	pa kʼax r>umal chi xa su jeʼ waʼ pa r>onojel wa u>wa ulew, xuqujeʼ
¿Jas che katbʼisonik?	¿Jas ch>e k>at>bʼison>ik?
Kaqaxiʼj qibʼ kaqachapo	Ka>qa>xiʼj q>ibʼ ka>qa>chap>o
Ukaj ukakʼal taqanik (24).	Ukaj ukakʼal taqanik (24).
«Kebʼ achijabʼ kepaqiʼ pa ri nim rachoch ri Dyos arech kechʼaw rukʼ ri Dyos. Jun chkech ri eʼareʼ, fariseʼo, e ri jun chik ajtoqʼinel pwaq.	«Kebʼ achij>abʼ k>e>paqiʼ pa ri nim r>achoch ri Dyos arech k>e>chʼaw r>ukʼ ri Dyos. Jun ch>k>ech ri eʼareʼ, fariseʼo, e ri jun chik ajtoqʼinel pwaq.
chi ke ri ixoqibʼ.	chi k>e ri ixoq>ibʼ.
Pa ri umajibʼal kʼo ri Tzij e ri Tzij kʼo rukʼ ri Dyos e ri Tzij are ri Dyos.	Pa ri u>majibʼal kʼo ri Tzij e ri Tzij kʼo r>ukʼ ri Dyos e ri Tzij are ri Dyos.
Pa le nimaqʼij rajawaxik kawiq le ja.	Pa le nimaqʼij rajawaxik ka>wiq le ja.
Rumal rech che iwonojel ix, ixralkʼuwaʼl ri Dyos rumal ri ikojonik chrech ri Jesus Kristo.	R>umal rech ch>e iw>onojel ix, ix>r>alkʼuwaʼl ri Dyos r>umal ri i>kojonik ch>r>ech ri Jesus Kristo.
winaq keʼtzijon pa uwiʼ jasa qas ri rajawixik che wa qatinimit kakʼiy	winaq k>eʼ>tzijon pa u>wiʼ jasa qas ri rajawixik ch>e wa qa>tinimit ka>kʼiy
Xa jekʼuriʼ eʼachalaxik, ri uj kʼo ri qachuqʼabʼ, arech kujok pa ri Tyoxlaj Kʼolibʼal rumal ri ukikʼel ri Jesus,	Xa jekʼuriʼ eʼ>achalaxik, ri uj kʼo ri qa>chuqʼabʼ, arech k>uj>ok pa ri Tyoxlaj Kʼolibʼal r>umal ri u>kikʼel ri Jesus,
Qonojel waʼ pa qʼabʼ la oj kʼo wi nudyos	Q>onojel waʼ pa qʼabʼ la oj kʼo wi nu>dyos
xuqujeʼ jastaq) kʼo chi uxol le 71% xuquje 83% chkech le ixoqibʼ xuqujeʼ chi uxoʼl le 58% xuqujeʼ	xuqujeʼ jastaq) kʼo chi u>xol le 71% xuquje 83% ch>k>ech le ixoq>ibʼ xuqujeʼ chi u>xoʼl le 58% xuqujeʼ
Ri watiʼt kʼo rulew je laʼ pa Taqʼaj.	Ri w>atiʼt kʼo r>ulew je laʼ pa Taqʼaj.
Säq rij ri chij.	Säq r>ij ri chij.
Ko ri ja.	Ko ri ja.
Xrietaʼmaj iawjilik	X>ri>etaʼma>j iawj>il>ik
Xepetik xolkilaʼ	X>e>pet>ik x>ol>k>il>aʼ
Rumal rech che pa ri areʼ kkʼuttajik ri usukʼil ri Dyos qas pa ri kojonik chi kʼateʼ pa ri kojonik chik 11.jeriʼ jacha tzʼibʼatalik: Ri sukʼalaj winaq kʼo ri ukʼaslemal pa ri kojonik.	R>umal rech ch>e pa ri areʼ k>kʼut>taj>ik ri u>sukʼil ri Dyos qas pa ri kojonik chi kʼateʼ pa ri kojonik chik 11.jeriʼ jacha tzʼibʼatalik: Ri sukʼalaj winaq kʼo ri u>kʼaslemal pa ri kojonik.
Tzebʼal ukemik le pas awumal	Tzebʼal u>kem>ik le pas aw>umal
Kawinaq julajuj qʼataj.	Kawinaq julajuj qʼataj.
pa ri nimalaj tinimit	pa ri nimalaj tinimit
Jawi xkibʼij wi	Jawi x>ki>bʼi>j wi
Kebʼe pa waʼim	K>e>bʼe pa waʼ>im
Xwaj xinʼek	X>w>aj x>in>ʼe>k
Ri eʼareʼ riʼ, ekʼo riʼ chkixoʼl ri nikʼaj che keʼok cho taq ja e kechubʼlin riʼ chkiwach ri man eʼutz taq ixoqibʼ taj che kʼo sibʼalaj kimak, kʼo sibʼalaj itzel taq kirayibʼal e kʼatekʼuriʼ	Ri eʼareʼ riʼ, ekʼo riʼ ch>ki>xoʼl ri nikʼaj ch>e k>eʼ>ok cho taq ja e k>e>chubʼlin riʼ ch>ki>wach ri man eʼ>utz taq ixoq>ibʼ taj ch>e kʼo sibʼalaj ki>mak, kʼo sibʼalaj itzel taq ki>rayibʼal e kʼatekʼuriʼ
Rumal rech che sibʼalaj ekʼi kesikʼixik, kʼatekʼut, man ekʼi taj ri kechaʼik».	R>umal rech ch>e sibʼalaj ekʼi k>e>sikʼix>ik, kʼatekʼut, man ekʼi taj ri k>e>chaʼ>ik».
Jas karaj kutijo ?	Jas ka>r>aj k>u>tij>o ?
Xojkichapo	X>oj>ki>chap>o
Xatalqilaʼ	X>at>al>q>il>aʼ
Latzʼ uwach ri ajchak.	Latzʼ u>wach ri ajchak.
Xatulik xatalkiʼkota	X>at>ul>ik x>at>al>kiʼkot>a
E julajuj ri äkʼ.	E julajuj ri äkʼ.
ri tinimit, we jeʼ waʼ are chiʼ oj kʼo pa jun tinimit jawi Junam wi	ri tinimit, we jeʼ waʼ are chiʼ oj kʼo pa jun tinimit jawi Junam wi
Ekabʼlajuj we eʼachijabʼ riʼ.	E>kabʼlajuj we eʼ>achij>abʼ riʼ.
Xekiqʼil le ajchakibʼ kakiwok le ja	X>e>ki>qʼil le ajchakibʼ ka>ki>wok le ja
kachakun pa uwiʼ jachin ri kakanaj kan che qʼatbʼaltzij chi a kajkaj	ka>chakun pa u>wiʼ jachin ri ka>kanaj kan ch>e qʼatbʼaltzij chi a kajkaj
Kawinaq oxibʼ qʼataj.	Kawinaq oxibʼ qʼataj.
Ri uj, man xa ta are kqaj kujtaqan puwiʼ ri ikojonik; man jeʼ ta riʼ, ri uj xane are kujtobʼan rukʼ ri ikiʼkotemal rumal rech che kʼo ri ichuqʼabʼ pa ri ikojonik.	Ri uj, man xa ta are k>qaj k>uj>taqan p>u>wiʼ ri i>kojonik; man jeʼ ta riʼ, ri uj xane are k>uj>tobʼan r>ukʼ ri i>kiʼkotemal r>umal rech ch>e kʼo ri i>chuqʼabʼ pa ri i>kojonik.
Kawaj kinʼek	Ka>w>aj k>in>ʼe>k
Kʼatekʼuriʼ, ri areʼ kqʼax ubʼi chkixoʼl, kbʼek.	Kʼatekʼuriʼ, ri areʼ k>qʼax u>bʼi ch>ki>xoʼl, k>bʼe>k.
Kʼo ulochʼ ri Talin.	Kʼo u>lochʼ ri Talin.
Chawilaʼ	Ch>aw>il>aʼ
arech are waʼ ri ktaqan chkech ri etyoxlaj taq winaq pa ri chak, arech qas utz ri ja rech ri Ubʼaqil ri Kristo,	arech are waʼ ri k>taqan ch>k>ech ri e>tyoxlaj taq winaq pa ri chak, arech qas utz ri ja rech ri U>bʼaqil ri Kristo,
Na xsachon ta chke xeatinik	Na x>sachon ta ch>k>e x>e>atin>ik
Man xuwi ta pakiwiʼ ri eʼareʼ kinchʼawik, xane xoqujeʼ kinchʼaw pakiwiʼ ri enikʼaj chik, che rumal ri kitzij ri eʼareʼ kekojon na chwech ri in arech,	Man xuwi ta pa>ki>wiʼ ri eʼareʼ k>in>chʼaw>ik, xane xoqujeʼ k>in>chʼaw pa>ki>wiʼ ri e>nikʼaj chik, ch>e r>umal ri ki>tzij ri eʼareʼ k>e>kojon na ch>w>ech ri in arech,
Ri ix, iwetaʼm che ri Uqʼij ri Ajawxel kpe riʼ jeʼ jas jun elaqʼom che kpe chaqʼabʼ.	Ri ix, iw>etaʼm ch>e ri U>qʼij ri Ajawxel k>pe riʼ jeʼ jas jun elaqʼom ch>e k>pe chaqʼabʼ.
Ri Oxlajuj Kej, nimaqʼij pa ri nutinamit.	Ri Oxlajuj Kej, nimaqʼij pa ri nu>tinamit.
Rumal rech, che xkʼuttajik ri usipanik ri Dyos, che ukʼiybʼalil ri kolotajem chkech konojel ri winaq,	R>umal rech, ch>e x>kʼut>taj>ik ri u>sipanik ri Dyos, ch>e u>kʼiybʼalil ri kolotajem ch>k>ech k>onojel ri winaq,
Kaqitzʼnaj ri uxajabʼ ri akʼal.	Ka>qitzʼnaj ri u>xajabʼ ri akʼal.
Xa jekʼuriʼ ix achalaxik; ri uj, man uj ralkʼuwaʼl ta ri ajpataninel ixoq, xane ujralkʼuwaʼl ri tzoqopitalik ixoq.	Xa jekʼuriʼ ix achalaxik; ri uj, man uj r>alkʼuwaʼl ta ri ajpataninel ixoq, xane uj>r>alkʼuwaʼl ri tzoqopitalik ixoq.
Ri areʼ kʼo jun rachalal, Mariʼy ri ubʼiʼ, tʼuyulik chuxkut ri raqan ri Jesus. Kuta ri utzij.	Ri areʼ kʼo jun r>achalal, Mariʼy ri u>bʼiʼ, tʼuyulik ch>u>xkut ri r>aqan ri Jesus. Kut>a ri u>tzij.
Wech ri kem.	W>ech ri kem.
Juwinaq kajlajuj qʼataj.	Juwinaq kajlajuj qʼataj.
Jas kawaj kintijo ?	Jas k>aw>aj k>in>tij>o ?
¿La katpe qukʼ chweʼq?	¿La k>at>pe q>ukʼ chweʼq?
Aninaqil katpetik.	Aninaqil k>at>pet>ik.
Xoqujeʼ ri itzel taq tzij, ri chʼuʼj taq tzij, ri mox taq tzij; ronojel weriʼ man utz taj, xane chixmaltyoxin chrech ri Ajawxel.	Xoqujeʼ ri itzel taq tzij, ri chʼuʼj taq tzij, ri mox taq tzij; r>onojel weriʼ man utz taj, xane ch>ix>maltyoxin ch>r>ech ri Ajawxel.
Chʼur ri jochʼ.	Chʼur ri jochʼ.
Juwinaq waqlajuj qʼataj:	Juwinaq waqlajuj qʼataj:
Kunanik	Kunanik
Jeʼlik ri qʼor äj rukʼ ri mux.	Jeʼl>ik ri qʼor äj r>ukʼ ri mux.
uwach.	u>wach.
Xuʼlukʼamaʼ	X>uʼl>u>kʼam>aʼ
Eʼachalaxik, ri urayibʼal ri wanimaʼ e ri urayibʼal ri nuchʼawem rukʼ ri Dyos, are che ri eʼareʼ kekʼolotajik.	Eʼachalaxik, ri u>rayibʼal ri w>animaʼ e ri u>rayibʼal ri nu>chʼawem r>ukʼ ri Dyos, are ch>e ri eʼareʼ k>e>kʼol>otaj>ik.
Aretaq chiʼ kqaj ri qʼij, kel ubʼi pa ri tinimit.	Aretaq chiʼ k>qaj ri qʼij, k>el u>bʼi pa ri tinimit.
cha ma kʼo ta kichak ri winaq,	cha ma kʼo ta ki>chak ri winaq,
Xkilo chi kinkʼoxomaj	X>k>il>o chi k>in>kʼoxoma>j
kyitzʼitzʼ ri nupam rumal ri kinäqʼ.	k>yitzʼitzʼ ri nu>pam r>umal ri kinäqʼ.
Na qʼalaj taj we kaʼek	Na qʼalaj taj we ka>ʼe>k
Pim ruq, ri ali.	Pim r>uq, ri ali.
Juwinaq kebʼ qʼataj.	Juwinaq kebʼ qʼataj.
Xkʼotochin chi kiwach chi xojalwoʼqa kukʼ	X>kʼotochin chi ki>wach chi x>oj>al>woʼ>qa k>ukʼ
Uwaq ukakʼal taqanik (26).	Uwaq ukakʼal taqanik (26).
qʼatbʼaltzij.	qʼatbʼaltzij.
le majaʼ qas kijunabʼ xuqujeʼ le nimaʼq kitijonik.	le majaʼ qas ki>junabʼ xuqujeʼ le nim>aʼq ki>tijonik.
Jeʼl ktijow ri käq qʼoqʼ.	Jeʼl k>tijow ri käq qʼoqʼ.
Kawinaq kajlajuj qʼataj.	Kawinaq kajlajuj qʼataj.
México (2000)	México (2000)
Utz kech ri winaq che xsach uwach ri retzalal e xchup uwach ri umak.	Utz k>ech ri winaq ch>e x>sach u>wach ri r>etzalal e x>chup u>wach ri u>mak.
¡Ri utzalaj usipanik ri Jesus, chkʼojiʼ bʼaʼ iwukʼ iwonojel! ¡Amen!	¡Ri utzalaj u>sipanik ri Jesus, ch>kʼojiʼ bʼaʼ iw>ukʼ iw>onojel! ¡Amen!
Uwuq taqanik (7).	Uwuq taqanik (7).
Kbʼin kukʼ pa ri Jerusalem, rukʼ chuqʼabʼ kchʼawik pa ri ubʼiʼ ri Ajawxel.	K>bʼin k>ukʼ pa ri Jerusalem, r>ukʼ chuqʼabʼ k>chʼaw>ik pa ri u>bʼiʼ ri Ajawxel.
Paʼtz rij ri tzʼiʼ.	Paʼtz r>ij ri tzʼiʼ.
Rilik	R>il>ik
Jeriʼ nakʼut, ri Pabʼlo xel ubʼik chkixoʼl ri eʼareʼ.	Jeriʼ nakʼut, ri Pabʼlo x>el ubʼik ch>ki>xoʼl ri eʼareʼ.
kichak, ronojel ri nima tinimit rajawixik kʼi kiwach ri kiwinaq	ki>chak, r>onojel ri nima tinimit rajawixik kʼi ki>wach ri ki>winaq
kqajik.	k>qaj>ik.
Qʼan ri nukaxa.	Qʼan ri nu>kaxa.
Ri Pabʼlo, apostol rech ri Kristo Jesus, rumal ri urayibʼal ri Dyos e ri Timoteʼo ri achalaxik,	Ri Pabʼlo, apostol rech ri Kristo Jesus, r>umal ri u>rayibʼal ri Dyos e ri Timoteʼo ri achalaxik,
Kremow ri qʼaqʼ.	K>remow ri qʼaqʼ.
Kakowinik kabʼinik	Ka>kowin>ik ka>bʼin>ik
Bʼay xaq si xintatabʼej na in	Bʼay xaq si x>in>tatabʼe>j na in
Xnaʼtaj chke chi xeatinik	X>naʼtaj ch>k>e chi x>e>atin>ik
Kʼo juchʼin chi upam ri tʼuʼy.	Kʼo juchʼin chi u>pam ri tʼuʼy.
E kebʼe pa jun tinimit chik.	E k>e>bʼe pa jun tinimit chik.
Kʼatekʼut, ri eʼareʼ man kʼo ta kkaj chrech weriʼ; jun kbʼe pa ri rulew, ri jun chik kbʼe pa ri ukʼay;	Kʼatekʼut, ri eʼareʼ man kʼo ta k>kaj ch>r>ech weriʼ; jun k>bʼe pa ri r>ulew, ri jun chik k>bʼe pa ri u>kʼay;
Xsachon chke chi xeatinik	X>sachon ch>k>e chi x>e>atin>ik
Kwaʼlaj chʼoʼj chkixoʼl ri winaq, man xa ta jun kiwach rumal ri areʼ.	K>waʼlaj chʼoʼj ch>ki>xoʼl ri winaq, man xa ta jun ki>wach r>umal ri areʼ.
Ri kej xtuqaʼrik chi uxeʼ le reqaʼn.	Ri kej x>tuqaʼr>ik chi u>xeʼ le r>eqaʼn.
Ri nukʼul ja ajitz.	Ri nu>kʼul ja ajitz.
Kʼo ij che le akʼal.	Kʼo ij ch>e le akʼal.
Uj kʼo pa qʼequʼm.	Uj kʼo pa qʼequʼm.
Ri roqʼej ri ali jacha kpe jun akʼal.	Ri r>oqʼej ri ali jacha k>pe jun akʼal.
chi pa ri Neʼapolis kujbʼe ubʼi pa ri Filipos, che jun tinimit che xas are nabʼe nim ubʼantajik pa ri Masedoniʼa; pa we jun tinimit riʼ ekʼo eʼajromano. Kujkanaj kebʼ oxibʼ qʼij pa we tinimit riʼ,	chi pa ri Neʼapolis k>uj>bʼe u>bʼi pa ri Filipos, ch>e jun tinimit ch>e xas are nabʼe nim u>bʼantajik pa ri Masedoniʼa; pa we jun tinimit riʼ ekʼo eʼ>ajromano. K>uj>kanaj kebʼ oxibʼ qʼij pa we tinimit riʼ,
e we xoqujeʼ rajawaxik kinbʼe in, kebʼe na kʼu riʼ ri eʼareʼ wukʼ in.	e we xoqujeʼ rajawaxik k>in>bʼe in, k>e>bʼe na kʼu riʼ ri eʼareʼ w>ukʼ in.
kibʼe chi e winaq xa e junam pa jun tinimit.	ki>bʼe chi e winaq xa e junam pa jun tinimit.
Waʼim xuchapo	Waʼ>im x>u>chap>o
Ri kaxlaʼn wa xpaqiʼ rajil.	Ri kaxlaʼn wa x>paqiʼ rajil.
Jas xsachon chqe xqachʼajo	Jas x>sachon ch>q>e x>qa>chʼaj>o
Xojrilo	X>oj>r>il>o
Xa jumul kyak uxeʼ ri tzʼin.	Xa jumul k>yak u>xeʼ ri tzʼin.
Kʼax waʼim awumal	Kʼax waʼ>im aw>umal
Xsachon chke xatkisikʼij	X>sachon ch>k>e x>at>ki>sikʼi>j
Ri ix, itom che xbʼixik: jun woqʼochaj utojbʼalil jun woqʼochaj e jun wareyaj utojbʼalil jun wareyaj.	Ri ix, i>tom ch>e x>bʼix>ik: jun woqʼoch>aj u>tojbʼalil jun woqʼoch>aj e jun wareyaj u>tojbʼalil jun wareyaj.
nabʼe mul waʼ chi kabʼixik chi cho wa Iximulew e kʼo winaq ri kʼi	nabʼe mul waʼ chi ka>bʼix>ik chi cho wa Iximulew e kʼo winaq ri kʼi
Kʼatekʼut ri areʼ, aretaq chiʼ kuta we tzij riʼ kbʼisonik rumal rech che ri areʼ sibʼalaj qʼinom.	Kʼatekʼut ri areʼ, aretaq chiʼ kut>a we tzij riʼ k>bʼison>ik r>umal rech ch>e ri areʼ sibʼalaj qʼinom.
Xujbʼe pa tzurik.	X>uj>bʼe pa tzurik.
Xnaʼtaj chke xeatinik	X>naʼtaj ch>k>e x>e>atin>ik
Juwinaq kabʼlajuj qʼataj.	Juwinaq kabʼlajuj qʼataj.
Kʼatekʼuriʼ, konojel ri eqʼaxal utzij ri Dyos, xas xechʼaw riʼ chi rukʼ ri Samueʼl uloq e konojel ri xepetik jeʼ jas ri areʼ, xechʼaw puwiʼ we jetaq qʼij riʼ.	Kʼatekʼuriʼ, k>onojel ri e>qʼaxal u>tzij ri Dyos, xas x>e>chʼaw riʼ chi r>ukʼ ri Samueʼl uloq e k>onojel ri x>e>pet>ik jeʼ jas ri areʼ, x>e>chʼaw p>u>wiʼ we jetaq qʼij riʼ.
“In, in Udyos ri Abʼraham, in, in Udyos ri Isaʼak, in, in Udyos ri Jakobʼ?”. Man jun Dyos taj kech kaminaqibʼ, ri areʼ jun Dyos kech ri ekʼaslik taq winaq».	“In, in U>dyos ri Abʼraham, in, in U>dyos ri Isaʼak, in, in U>dyos ri Jakobʼ?”. Man jun Dyos taj k>ech kaminaq>ibʼ, ri areʼ jun Dyos k>ech ri e>kʼaslik taq winaq».
rumal chi ma pa jun tinimit ta chik xpe wi wa xbʼanik, waʼ pa	r>umal chi ma pa jun tinimit ta chik x>pe wi wa x>bʼan>ik, waʼ pa
Achalaxik, ri ix iwetaʼm che ri qokibʼal pa ri itinimit, kʼo wi ri upatan.	Achalaxik, ri ix iw>etaʼm ch>e ri q>okibʼal pa ri i>tinimit, kʼo wi ri u>patan.
37. Kilitajik chi pa taq ri junabʼ 90	37. K>ilitaj>ik chi pa taq ri junabʼ 90
Ri kuxlabʼal ri eqʼaxel utzij ri Dyos chi keniman wi chkiwach ri eqʼaxel utzij ri Dyos;	Ri k>uxlabʼal ri e>qʼaxel u>tzij ri Dyos chi k>e>niman wi ch>ki>wach ri e>qʼaxel u>tzij ri Dyos;
Chiwech ri ix ri sipanik e ri utzilal rech ri Dyos Qatatxel e Utatxel ri Ajawxel Jesus Kristo,	Ch>iw>ech ri ix ri sipanik e ri utzilal rech ri Dyos Qa>tatxel e U>tatxel ri Ajawxel Jesus Kristo,
Pa waram xutaqchiʼj wi	Pa war>am x>u>taqchiʼ>j wi
Kʼo oxlajuj ujunabʼ ri numiʼal.	Kʼo oxlajuj u>junabʼ ri nu>miʼal.
Xsachon ri nuchak chwe	X>sachon ri nu>chak ch>w>e
Ri xaʼr kʼo pa uwiʼ ri qʼaqʼ kpoqʼowik.	Ri xaʼr kʼo pa u>wiʼ ri qʼaqʼ k>poqʼow>ik.
Ri areʼ kwaʼlajik e kbʼe cho ri rachoch.	Ri areʼ k>waʼlaj>ik e k>bʼe cho ri r>achoch.
Xekiqʼil le ajchakibʼ xkiwok le ja	X>e>ki>qʼil le ajchakibʼ x>ki>wok le ja
Ri utzijobʼäl ri Naʼ are ri Ixil. 	Ri u>tzijobʼäl ri Naʼ are ri Ix>il. 
Ri rilik we kʼo kakʼex pa ri utzij ri qʼatbʼaltzij ri uxoʼl kitijonik	Ri rilik we kʼo ka>kʼex pa ri u>tzij ri qʼatbʼaltzij ri u>xoʼl ki>tijonik
Rumal rech che ri Dyos, xa jun chi Dyos e xa jun ri kchʼaw paqawiʼ ri uj ujwinaq rukʼ ri Dyos, che are ri Kristo Jesus che jun achi ri areʼ,	R>umal rech ch>e ri Dyos, xa jun chi Dyos e xa jun ri k>chʼaw pa>qa>wiʼ ri uj uj>winaq r>ukʼ ri Dyos, ch>e are ri Kristo Jesus ch>e jun achi ri areʼ,
Xateʼqilaʼ	X>at>eʼ>q>il>aʼ
Ri Pabʼlo kel bʼi naj che ri Atenas, kbʼe ubʼi pa ri Korinto.	Ri Pabʼlo k>el bʼi naj ch>e ri Atenas, k>bʼe u>bʼi pa ri Korinto.
Entonses are kʼwaʼ le kawaj kinbʼij	Entonses are kʼ>waʼ le k>aw>a>j k>in>bʼij
La xatwaʼ kʼut?	La x>at>waʼ kʼut?
E kukʼ taq ri eqamam eqatat, yaʼtalik rumal ri Dyos che konojel tinimit kebʼinik pa ri ubʼe;	E k>ukʼ taq ri e>qa>mam e>qa>tat, yaʼtalik r>umal ri Dyos ch>e k>onojel tinimit k>e>bʼin>ik pa ri u>bʼe;
Wachʼom ri kiwa ri noʼs.	Wachʼom ri ki>wa ri noʼs.
Kʼatekʼuriʼ jumul chik, man junam ta chi kiwach ri eʼajjudiʼo, rumal rech we tzij riʼ.	Kʼatekʼuriʼ jumul chik, man junam ta chi ki>wach ri eʼ>ajjudiʼo, r>umal rech we tzij riʼ.
Ri ixim qʼän kʼo na chi uwach ri saqwäch.	Ri ixim qʼän kʼo na chi u>wach ri saqwäch.
Xinwetaʼmaj chi na xatpe taj	X>inw>etaʼma>j chi na x>at>pe taj
Kawinaq kijabʼ qʼataj.	Kawinaq ki>jabʼ qʼataj.
Xojutaqchiʼij xojwaʼik	X>oj>u>taqchiʼi>j x>oj>waʼ>ik
chak kabʼanik.	chak ka>bʼan>ik.
Kʼo chilaʼ chuwach ri areʼ jun iwabʼ achi sipojinaq ubʼaqil.	Kʼo chilaʼ ch>u>wach ri areʼ jun iw>abʼ achi sipojinaq u>bʼaqil.
xnimarik.	x>nimar>ik.
Ri Jesus kkʼiy ri retaʼmabʼal, ri unimal raqan e ri utoqʼobʼ chuwach ri Dyos e chkiwach ri winaq.	Ri Jesus k>kʼiy ri r>etaʼmabʼal, ri u>nimal r>aqan e ri u>toqʼobʼ ch>u>wach ri Dyos e ch>ki>wach ri winaq.
Chixniman bʼaʼ chkech konojel ajawabʼ qas rumal rech ri Ajawxel; chixniman bʼaʼ chrech ri ajawinel jeriʼ che jun ajawinel,	Ch>ix>niman bʼaʼ ch>k>ech k>onojel ajaw>abʼ qas r>umal rech ri Ajawxel; ch>ix>niman bʼaʼ ch>r>ech ri ajawinel jeriʼ ch>e jun ajawinel,
ktikik jun winaq pa ri ukʼaslemal chuwachulew kkʼastaj uwach pa jun uxlabʼal bʼaqilal. We kʼo ukʼaslemal jun bʼaqilal rech uwachulew, xoqujeʼ kʼo jun uxlabʼal bʼaqilal.	k>tik>ik jun winaq pa ri u>kʼaslemal ch>uwachulew k>kʼastaj u>wach pa jun uxlabʼal bʼaqilal. We kʼo u>kʼaslemal jun bʼaqilal rech uwachulew, xoqujeʼ kʼo jun uxlabʼal bʼaqilal.
Jas rukʼ xkitij wi le kirikil?	Jas r>ukʼ x>ki>tij wi le ki>rikil?
Umajibʼal taq junabʼ 1990	U>majibʼal taq junabʼ 1990
«Ma naj ta chik, kʼatekʼuriʼ man kiwil ta chi nuwach waʼ, kʼatekʼuriʼ, man naj ta chi kʼuriʼ kiwil chi na nuwach riʼ».	«Ma naj ta chik, kʼatekʼuriʼ man ki>wil ta chi nu>wach waʼ, kʼatekʼuriʼ, man naj ta chi kʼuriʼ ki>wil chi na nu>wach riʼ».
Ronojel.	R>onojel.
Katchakunik rech keatzuq le awalkʼwal	K>at>chakun>ik r>ech k>e>a>tzuq le aw>alkʼwal
E kʼi ri kʼat kʼolik.	E kʼi ri kʼat kʼol>ik.
arech ri in, in jun ajpataninel rech ri Kristo Jesus chkixoʼl ri man eʼajjudiʼo taj, in ajyuqʼ chrech ri utzalaj Tzij rech ri Dyos, arech ri man eʼajjudiʼo taj ejun utzalaj tabʼal toqʼobʼ e etyox pa ri Tyoxlaj Uxlabʼaxel.	arech ri in, in jun ajpataninel rech ri Kristo Jesus ch>ki>xoʼl ri man eʼ>ajjudiʼo taj, in ajyuqʼ ch>r>ech ri utzalaj Tzij rech ri Dyos, arech ri man eʼ>ajjudiʼo taj e>jun utzalaj tabʼal toqʼobʼ e e>tyox pa ri Tyoxlaj Uxlabʼaxel.
Kqʼaqʼan ri waqän.	K>qʼaqʼan ri w>aqän.
?xinwil le ukunaxik le achi rumal le ixoq	?x>inw>il le u>kuna>x>ik le achi r>umal le ixoq
Kexojow ri ajxojolobʼ.	K>e>xojow ri ajxojolobʼ.
Amaqʼ.	Amaqʼ.
Are kawaj na kinʼe taj	Are ka>w>aj na k>in>ʼe taj
chik, pa cha ri, ma utz ta rilik ri jasa taq re ri tinimit kabʼanik, xa jun.	chik, pa cha ri, ma utz ta rilik ri jasa taq r>e ri tinimit ka>bʼan>ik, xa jun.
ukʼisbʼal junabʼ.	u>kʼisbʼal junabʼ.
Kkʼat ri siʼ pa ri qʼaqʼ.	K>kʼat ri siʼ pa ri qʼaqʼ.
«Ri uj, uj ajjudiʼo chi aretaq chiʼ xujalaxik uloq e ri uj man uj ajmakunelabʼ taj jeʼ jas ri man eʼajjudiʼo taj;	«Ri uj, uj ajjudiʼo chi aretaq chiʼ x>uj>alax>ik uloq e ri uj man uj ajmakunel>abʼ taj jeʼ jas ri man eʼ>ajjudiʼo taj;
¡jun toqʼobʼ chiwech e nimalaj utzil pa ri ubʼiʼ ri Dyos, ri Qatat, e pa ri ubʼiʼ ri Ajawxel Jesus Kristo!	¡jun toqʼobʼ ch>iw>ech e nimalaj utzil pa ri u>bʼiʼ ri Dyos, ri Qa>tat, e pa ri u>bʼiʼ ri Ajawxel Jesus Kristo!
Nabʼe ubʼiʼ:	Nabʼe u>bʼiʼ:
Rumal rech che kʼo xa jun kaxlanwa, qonojel xa uj jun bʼaqilal, rumal rech che qonojel kʼo qech chrech we jun chi kaxlanwa riʼ.	R>umal rech ch>e kʼo xa jun kaxlanwa, q>onojel xa uj jun bʼaqilal, r>umal rech ch>e q>onojel kʼo q>ech ch>r>ech we jun chi kaxlanwa riʼ.
Ri chʼuʼ ktij rukʼ lej.	Ri chʼuʼ k>tij r>ukʼ lej.
Jun laj neʼ kʼo chupam	Jun laj neʼ kʼo ch>u>pam
Awech le ja.	Aw>ech le ja.
Ri chomanik rajawixik chi ri chomanik retaʼm ri noʼj kachʼaw pa	Ri chomanik rajawixik chi ri chomanik r>etaʼm ri noʼj ka>chʼaw pa
Ri watiʼt Waʼn retaʼm ri ojer tzij.	Ri w>atiʼt Waʼn r>etaʼm ri ojer tzij.
Konojel xemakunik e man kʼo ta ri uqʼijil ri Dyos kukʼ–	K>onojel x>e>makun>ik e man kʼo ta ri u>qʼijil ri Dyos k>ukʼ–
are ri areʼ ri xbʼin chqech ri loqʼoqʼebʼal ikʼuʼx ix pa ri Uxlabʼaxel.	are ri areʼ ri x>bʼin ch>q>ech ri loqʼoqʼebʼal i>kʼuʼx ix pa ri Uxlabʼaxel.
Ajpatan ri Teʼk.	Ajpatan ri Teʼk.
Ri Itat chikaj retaʼm chik che ri ix rajawaxik weriʼ chiwech.	Ri I>tat chikaj r>etaʼm chik ch>e ri ix rajawaxik weriʼ ch>iw>ech.
kʼatekʼut, chkiwach ri esikʼitalik, kneʼbʼaʼ eʼajjudiʼo on eʼajgriʼego, waʼ we areʼ riʼ are ri Kristo, che uchuqʼabʼ ri Dyos e retaʼmabʼal ri Dyos.	kʼatekʼut, ch>ki>wach ri e>sikʼitalik, kneʼbʼaʼ eʼ>ajjudiʼo on eʼ>ajgriʼego, waʼ we areʼ riʼ are ri Kristo, ch>e u>chuqʼabʼ ri Dyos e r>etaʼmabʼal ri Dyos.
Xqasikʼij le ixoq	X>qa>sikʼi>j le ixoq
Xepetik rech kewaʼ iwukʼ	X>e>pet>ik r>ech k>e>waʼ iw>ukʼ
Xubʼij chwe jawi at kʼo wi	X>u>bʼij ch>w>e jawi at kʼo wi
Kʼo jun achiʼ, taqom uloq rumal ri Dyos, Xwan ri ubʼiʼ areʼ.	Kʼo jun achiʼ, taqom uloq r>umal ri Dyos, Xwan ri u>bʼiʼ areʼ.
Xinwil wibʼ	X>inw>il w>ibʼ
Xsachon chke xeatinik	X>sachon ch>k>e x>e>atin>ik
Kʼatekʼuriʼ, we man xkʼastaj ta uwach ri Kristo, man kʼo ta ukʼuʼx riʼ ri qatzij, xoqujeʼ man kʼo ta ukʼuʼx riʼ ri qakojonik.	Kʼatekʼuriʼ, we man x>kʼastaj ta u>wach ri Kristo, man kʼo ta u>kʼuʼx riʼ ri qa>tzij, xoqujeʼ man kʼo ta u>kʼuʼx riʼ ri qa>kojonik.
Xsachon chke jachin xeatinik	X>sachon ch>k>e jachin x>e>atin>ik
Xnaʼtaj ri akʼal chwe	X>naʼtaj ri akʼal ch>w>e
Kawaj kinbʼij	Ka>w>aj k>in>bʼi>j
Chi chanim kbʼix chkech pa jun ichikʼ arech ma ketzalej ta chik rukʼ ri Herodes. Kebʼe pa jun bʼe chik arech ketzalij pa ri kamaqʼ.	Chi chanim k>bʼix ch>k>ech pa jun ichikʼ arech ma k>e>tzalej ta chik r>ukʼ ri Herodes. K>e>bʼe pa jun bʼe chik arech k>e>tzalij pa ri k>amaqʼ.
Kʼo kʼi taq uwach ri utoqʼobʼ ri Uxlabʼxel, kʼatekʼut xas xa jun chi Uxlabʼxel;	Kʼo kʼi taq u>wach ri u>toqʼobʼ ri Uxlabʼxel, kʼatekʼut xas xa jun chi Uxlabʼxel;
Qech ri ja.	Q>ech ri ja.
Kinbʼe na kukʼ ri molaj.	K>in>bʼe na k>ukʼ ri molaj.
Tzʼaqat ri	Tzʼaqat ri
Kʼax ukemik le pas chawe	Kʼax u>kem>ik le pas ch>aw>e
chaban chech.	ch>aban ch>ech.
Enikʼaj winaq, che man xekanaj ta kan pa weriʼ, xeqaj pa nikʼaj joʼs taq tzij;	E>nikʼaj winaq, ch>e man x>e>kanaj ta kan pa weriʼ, x>e>qaj pa nikʼaj joʼs taq tzij;
Jobʼ Qʼataj. Ri uchak ri Woktzʼibʼabʼal.	Jobʼ Qʼataj. Ri u>chak ri Woktzʼibʼabʼal.
qʼatbʼaltzij, pa cha ri (ri chajinel re rilik ri ukojik ri qʼatbʼaltzij,	qʼatbʼaltzij, pa cha ri (ri chajinel r>e rilik ri u>kojik ri qʼatbʼaltzij,
Roqorik ri ratzʼyaq ri a Xwan.	Roqorik ri r>atzʼyaq ri a Xwan.
kiwach winaq	ki>wach winaq
kichuqʼabʼ wakamik.	ki>chuqʼabʼ wakamik.
Arechiʼ naqaj chik kʼo wi che ri tinamit, koqʼ puwiʼ ri tinamit.	Arechiʼ naqaj chik kʼo wi ch>e ri tinamit, k>oqʼ p>u>wiʼ ri tinamit.
Xuchap ukunaxik	X>u>chap u>kuna>x>ik
jeriʼ na kʼuriʼ, we xqaj chiwach che ri Ajawxel utzalaj Ajawawxel.	jeriʼ na kʼuriʼ, we x>qaj ch>i>wach ch>e ri Ajawxel utzalaj Ajawawxel.
Jumuchʼ ri nujunabʼ.	Jumuchʼ ri nu>junabʼ.
chäj, chkech ri winaq che man kekojon taj jacha ri uj, e nimalaj uqʼijil chrech ri siwan atinimit Israʼel».	chäj, ch>k>ech ri winaq ch>e man k>e>kojon taj jacha ri uj, e nimalaj u>qʼijil ch>r>ech ri siwan a>tinimit Israʼel».
Chi pa ri Mileto wi, ktaqan uloq arech ri enim winaq rech ri Komon Tyox pa ri Efeso, kepe rukʼ ri areʼ.	Chi pa ri Mileto wi, k>taqan uloq arech ri e>nim winaq rech ri Komon Tyox pa ri Efeso, k>e>pe r>ukʼ ri areʼ.
Juwinaq wuqubʼ qʼataj.	Juwinaq wuqubʼ qʼataj.
Kʼatekʼuriʼ, ri Max che jun chkixoʼl ri ekabʼlajuj, ri kbʼix Yoʼx (Didyme) chrech, man kʼo ta kukʼ aretaq chiʼ xpe ri Jesus.	Kʼatekʼuriʼ, ri Max ch>e jun ch>ki>xoʼl ri e>kabʼlajuj, ri k>bʼix Yoʼx (Didyme) ch>r>ech, man kʼo ta k>ukʼ aretaq chiʼ x>pe ri Jesus.
Xsachon chwe xinatinik	X>sachon ch>w>e x>in>atin>ik
wa Iximulew.	wa Iximulew.
Aretaq chiʼ ri areʼ kʼo chik kabʼlajuj ujunabʼ, xoqujeʼ kepaqiʼ ubʼik rumal ri nimaqʼij.	Aretaq chiʼ ri areʼ kʼo chik kabʼlajuj u>junabʼ, xoqujeʼ k>e>paqiʼ ubʼik r>umal ri nimaqʼij.
Xloʼtaj ri akʼal.	X>loʼtaj ri akʼal.
Jas xojukʼam lo chukʼayixik?	Jas x>oj>u>kʼam lo ch>u>kʼayi>x>ik?
We na jupulik ta xeqajik...	We na jup>ul>ik ta x>e>qaj>ik...
cheʼtzijon pa uwiʼ ronojel taq ri rajawixik chi ke keʼtzijon pa uwiʼ. Pa	ch>eʼ>tzijon pa u>wiʼ r>onojel taq ri rajawixik chi k>e k>eʼ>tzijon pa u>wiʼ. Pa
3. Are chiʼ ri kʼaxkʼolil kebʼ oxibʼ winaq kebʼanowik.	3. Are chiʼ ri kʼaxkʼolil kebʼ oxibʼ winaq k>e>bʼan>ow>ik.
re ri tinimit. Ri jun chak ri xbʼanik are xkʼamow ubʼe ri nimalaj	r>e ri tinimit. Ri jun chak ri x>bʼan>ik are x>kʼamow u>bʼe ri nimalaj
ejujun chik kʼo taj kech.	e>jujun chik kʼo taj k>ech.
Kʼaʼn ri kʼayinel chʼichʼ.	Kʼaʼn ri kʼayinel chʼichʼ.
Kawaj chi katʼek	Ka>w>a>j chi k>at>ʼe>k
natural taj.	natural taj.
Jat xinchaʼ chi awe.	Jat x>in>chaʼ chi aw>e.
chrech ri Timoteʼo, ri loqʼalaj walkʼuwaʼl, chech areʼ ri usipanik ri Dyos, ri loqʼoqʼebʼal ukʼuʼx, ri utzil rumal ri Dyos Tatxel e rumal ri Kristo Jesus Qajawxel.	ch>r>ech ri Timoteʼo, ri loqʼalaj w>alkʼuwaʼl, ch>ech areʼ ri u>sipanik ri Dyos, ri loqʼoqʼebʼal u>kʼuʼx, ri utzil r>umal ri Dyos Tatxel e r>umal ri Kristo Jesus Q>ajawxel.
ri areʼ che kamik riʼ kʼo pa kaj pa ri rikyaqʼabʼ ri Dyos, e chuxeʼ raqan ri areʼ kojom ri jetaq Ajawibʼal e ri jetaq kowinem.	ri areʼ ch>e kamik riʼ kʼo pa kaj pa ri r>ikyaqʼabʼ ri Dyos, e ch>u>xeʼ r>aqan ri areʼ kojom ri jetaq Ajawibʼal e ri jetaq kowinem.
Keʼaqʼan pa ri jukubʼ e kqaj uwach ri kyaqiqʼ.	K>eʼ>aqʼan pa ri jukubʼ e k>qaj u>wach ri kyaqiqʼ.
Ri bʼe laj uwach.	Ri bʼe laj u>wach.
kʼatekʼuriʼ, kamik riʼ, ri ix man ixpataninel ta chi rech ri makaj, xane ixpataninel rech ri sukʼil	kʼatekʼuriʼ, kamik riʼ, ri ix man ix>pataninel ta chi rech ri makaj, xane ix>pataninel rech ri sukʼil
ri rajawixik chi ke. Xuqujeʼ, oxibʼ ri jasa taq ri jasa taq ri ojer ma	ri rajawixik chi k>e. Xuqujeʼ, oxibʼ ri jasa taq ri jasa taq ri ojer ma
Juwinaq jobʼ qʼataj.	Juwinaq jobʼ qʼataj.
Ri jaʼ kamiqʼik chi uwach ri qʼaqʼ.	Ri jaʼ ka>miqʼ>ik chi u>wach ri qʼaqʼ.
Xojilik	X>oj>il>ik
Weta ronojel xaq jun uwach utzʼaqatil, ¿jawiʼ kʼu riʼ kʼo wi ri bʼaqilal?	Weta r>onojel xaq jun u>wach u>tzʼaqatil, ¿jawiʼ kʼu riʼ kʼo wi ri bʼaqilal?
Kjaʼjat chi wij.	K>jaʼjat chi w>ij.
(pa Kʼicheʼ chʼawem).	(pa Kʼicheʼ chʼawem).
Jewaʼ kkanajik:	Jewaʼ k>kanaj>ik:
Kiʼ ri kabʼ.	Kiʼ ri k>abʼ.
Are chiʼ kinbʼisonik kinoqʼik.	Are chiʼ k>in>bʼison>ik k>in>oqʼ>ik.
Moʼr kkaʼy ri nuchʼichʼ.	Moʼr k>kaʼy ri nu>chʼichʼ.
Aretaq chiʼ jewaʼ kchʼawik, ekʼi sibʼalaj kekojon chrech ri areʼ.	Aretaq chiʼ jewaʼ k>chʼaw>ik, ekʼi sibʼalaj k>e>kojon ch>r>ech ri areʼ.
Kʼo nukʼulel.	Kʼo nu>kʼulel.
Pa wa nima Tinimit Iximulew, ukaj ikʼ re ri junabʼ 1999.	Pa wa nima Tinimit Iximulew, ukaj ikʼ r>e ri junabʼ 1999.
Kʼatekʼuriʼ, ri Jerusalem chikaj are riʼ ri tzoqopitalik e ri areʼ, are na kʼu riʼ ri qanan;	Kʼatekʼuriʼ, ri Jerusalem chikaj are riʼ ri tzoqopitalik e ri areʼ, are na kʼu riʼ ri qa>nan;
Xa jekʼuriʼ, ronojel mul ujnojinaq che ri qachuqʼabʼ, qetaʼm che aretaq chiʼ uj kʼo na pa we qabʼaqilal riʼ, ri qakʼaslemal naj waʼ kʼo wi chrech ri Ajawxel,	Xa jekʼuriʼ, r>onojel mul uj>nojinaq ch>e ri qa>chuqʼabʼ, q>etaʼm ch>e aretaq chiʼ uj kʼo na pa we qa>bʼaqilal riʼ, ri qa>kʼaslemal naj waʼ kʼo wi ch>r>ech ri Ajawxel,
Kabʼison ri Leʼn.	Ka>bʼison ri Leʼn.
Kawinaq waqlajuj qʼataj.	Kawinaq waqlajuj qʼataj.
Chkʼojiʼ bʼaʼ xa jun chi ibʼaqil e xa jun chi Uxlabʼaxel, e chkʼojiʼ bʼaʼ xa jun chi iweyeʼbʼal pa ri ixsikʼitalik wi;	Ch>kʼojiʼ bʼaʼ xa jun chi i>bʼaqil e xa jun chi Uxlabʼaxel, e ch>kʼojiʼ bʼaʼ xa jun chi iw>eyeʼbʼal pa ri ix>sikʼitalik wi;
Xanimaj ri akʼal chi uwach ri uchuch.	X>animaj ri akʼal chi u>wach ri u>chuch.
La waral kʼu xixwaʼ wi?	La waral kʼu x>ix>waʼ wi?
Ri uj kʼo jun qatabʼal toqʼobʼ che jawi, ri eʼajpatanijel pa ri panibʼal, man yaʼtal ta chkech arech kewaʼ ri eʼareʼ chilaʼ.	Ri uj kʼo jun qa>tabʼal toqʼobʼ ch>e jawi, ri eʼ>ajpatanijel pa ri panibʼal, man yaʼtal ta ch>k>ech arech k>e>waʼ ri eʼareʼ chilaʼ.
Ix, achalaxik, we kʼo jun chixoʼl ri ix, naj kbʼe wi chrech ri saqalajtzij, kʼatekʼuriʼ, jun chik kkʼamow chi uloq pa ri saqalajtzij,	Ix, achalaxik, we kʼo jun ch>i>xoʼl ri ix, naj k>bʼe wi ch>r>ech ri saqalajtzij, kʼatekʼuriʼ, jun chik k>kʼamow chi uloq pa ri saqalajtzij,
Iximulew.	Iximulew.
Xutaqchiʼj pa waram pulew	X>u>taqchiʼ>j pa war>am p>ulew
kanoq.	kan>oq.
Wetaʼam jachin kapetik	W>etaʼ>am jachin ka>pet>ik
Xinqʼiʼo na xinatin taj	X>in>qʼiʼ>o na x>in>atin taj
Xuta jampaʼ kojʼek	X>u>ta jampaʼ k>oj>ʼe>k
Na xinta taj we kixkitzuqu	Na x>in>ta taj we k>ix>ki>tzuq>u
Areʼ xraj xinbʼano	Areʼ x>r>a>j x>in>bʼan>o
Kaqilo chi na kojukʼam taj	Ka>q>il>o chi na k>oj>u>kʼam taj
Na xqil ta chik chi kukʼam rajil	Na x>q>il ta chik chi k>u>kʼam rajil
ri ubʼe, ri ucholaj.	ri u>bʼe, ri u>cholaj.
In ri in Alfa e ri Omega kcha ri Ajawxel Dyos, «ri are Areʼ, ri Areʼ Iwir, e ri Areʼ che kpe na riʼ», ri Ajaw che rajaw ronojel jas uwach.	In ri in Alfa e ri Omega k>cha ri Ajawxel Dyos, «ri are Areʼ, ri Areʼ Iwir, e ri Areʼ ch>e k>pe na riʼ», ri Ajaw ch>e r>ajaw r>onojel jas u>wach.
Chi are ta bʼaʼ ri Dyos, Qatatxel e Qajawxel Jesus, kkʼamow ubʼi ri qabʼe chi iwukʼ ix.	Chi are ta bʼaʼ ri Dyos, Qa>tatxel e Q>ajawxel Jesus, k>kʼamow u>bʼi ri qa>bʼe chi iw>ukʼ ix.
Ri ukʼuʼx tzʼibʼ pa qatzij e lajuj.	Ri u>kʼuʼx tzʼibʼ pa qa>tzij e lajuj.
Jun riʼ ri uqʼijil ri qʼij, jun chi riʼ ri uqʼijil ri ikʼ, jun chik ri uqʼijil ri taq chʼumil. Kʼatekʼuriʼ, ri uqʼijil jun chʼumil man junam ta rukʼ ri uqʼijil jun chik chʼumil.	Jun riʼ ri u>qʼijil ri qʼij, jun chi riʼ ri u>qʼijil ri ikʼ, jun chik ri u>qʼijil ri taq chʼumil. Kʼatekʼuriʼ, ri u>qʼijil jun chʼumil man junam ta r>ukʼ ri u>qʼijil jun chik chʼumil.
arech ri uj, aretaq chiʼ uj sukʼ chi rumal ri usipanik ri Kristo Jesus, kkʼojiʼ ri qeyeʼbʼal pa ri junalikalaj kʼaslemal.	arech ri uj, aretaq chiʼ uj sukʼ chi r>umal ri u>sipanik ri Kristo Jesus, k>kʼojiʼ ri q>eyeʼbʼal pa ri junalik>alaj kʼaslemal.
Xinnabʼej chutasik qakʼolibʼal	X>in>nabʼej ch>u>tas>ik qa>kʼolibʼal
México (1992-2002)	México (1992-2002)
Ajchak ri achi.	Ajchak ri achi.
Aretaq chiʼ, xujopan pa ri Masedoniʼa, ri qabʼaqil man xuxlan taj, xane pa ronojel kʼolibʼal kʼo sibʼalaj kʼax: jelaʼ kʼo taq ri chʼoʼj e waral riʼ kʼo ri xibʼrikil 17.	Aretaq chiʼ, x>uj>opan pa ri Masedoniʼa, ri qa>bʼaqil man x>uxlan taj, xane pa r>onojel kʼolibʼal kʼo sibʼalaj kʼax: jelaʼ kʼo taq ri chʼoʼj e waral riʼ kʼo ri xibʼrikil 17.
Keʼopan rukʼ ri areʼ, ri Jerusalem, ronojel ri Judeʼa e ronojel ri siwantinimit ekʼo pa ri Jordan.	K>eʼ>opan r>ukʼ ri areʼ, ri Jerusalem, r>onojel ri Judeʼa e r>onojel ri siwantinimit ekʼo pa ri Jordan.
rumal rech che kujbʼin pa ri qakojonik e man kujbʼin ta pa jun jas uwach che kilitajik uwach.	r>umal rech ch>e k>uj>bʼin pa ri qa>kojonik e man k>uj>bʼin ta pa jun jas u>wach ch>e k>ilitaj>ik u>wach.
rumal rech che iwonojel ri ix, ix ralkʼuwaʼl ri chaj saqil e ix ralkʼuwaʼl ri qʼij. Ri uj, man uj rech ta ri chaqʼabʼ e man uj rech ta ri qʼequʼmal.	r>umal rech ch>e iw>onojel ri ix, ix r>alkʼuwaʼl ri chaj saqil e ix r>alkʼuwaʼl ri qʼij. Ri uj, man uj rech ta ri chaqʼabʼ e man uj rech ta ri qʼequʼmal.
«Chixkanaj kan bʼaʼ rukʼ iwatzʼyaq e rukʼ ri tzijtalik bʼa kanoq.	«Ch>ix>kanaj kan bʼaʼ r>ukʼ iw>atzʼyaq e r>ukʼ ri tzijtalik bʼa kan>oq.
Petinaq chik ri Qʼaxebʼal kech ri eʼajjudiʼo, kʼatekʼuriʼ ri Jesus kpaqiʼ ubʼi pa ri Jerusalem.	Petinaq chik ri Qʼaxebʼal k>ech ri eʼ>ajjudiʼo, kʼatekʼuriʼ ri Jesus k>paqiʼ u>bʼi pa ri Jerusalem.
Junabʼ (on jun chik naqaj che)	Junabʼ (on jun chik naqaj ch>e)
Kamik kʼakʼ ikʼ.	Kamik kʼakʼ ikʼ.
Xpuluw ri tʼuʼy pa ri qʼaqʼ.	X>puluw ri tʼuʼy pa ri qʼaqʼ.
Wetaʼam chi pulew xwar wi	W>etaʼ>am chi p>ulew x>war wi
...kinbʼij chi are waʼ sin xiʼan	...k>in>bʼi>j chi are waʼ sin x>i>ʼan
Xqilo chi na kukʼam ta rajil le asosyasyon	X>q>il>o chi na k>u>kʼam ta rajil le asosyasyon
Mem ri achi.	Mem ri achi.
Xojutaqchiʼj le achi chuloqʼik ichaj	X>oj>u>taqchiʼ>j le achi ch>u>loqʼ>ik ichaj
Chiwech ri ix, ri nimalaj usipanik e ri rutzil ri Dyos Qatatxel, ri usipanik ri Ajawxel Jesus Kristo.	Ch>iw>ech ri ix, ri nimalaj u>sipanik e ri r>utzil ri Dyos Qa>tatxel, ri u>sipanik ri Ajawxel Jesus Kristo.
Jeʼl ktijow ri äj.	Jeʼl k>tijow ri äj.
kʼut.	kʼut.
Kiʼ ri ukabʼ ri aqaj.	Kiʼ ri ukabʼ ri aqaj.
Xuyupubʼa uwach raʼchi, kachaʼ,	X>u>yup>ubʼa u>wach raʼchi, ka>chaʼ,
Man ketaʼm ta ri ubʼe ri nimalaj utzil,	Man k>etaʼm ta ri u>bʼe ri nimalaj utzil,
Xujel ubʼik chilaʼ, xujqʼax chuchiʼ ri rulew ri Chipre, rumal rech che ri kyaqiqʼ petinaq uloq chqawach.	X>uj>el ubʼik chilaʼ, x>uj>qʼax ch>u>chiʼ ri r>ulew ri Chipre, r>umal rech ch>e ri kyaqiqʼ petinaq uloq ch>qa>wach.
Al ri chakäch.	Al ri chakäch.
Ubʼelej taqanik (9).	Ubʼelej taqanik (9).
Rumal rech, che ri uj qetaʼm, che uxlabʼal ri Pixabʼ, kʼatekʼut, ri in, in kʼo pa nubʼaqil, e ri nubʼaqil kʼo pa ri ukowinem ri makaj.	R>umal rech, ch>e ri uj q>etaʼm, ch>e uxlabʼal ri Pixabʼ, kʼatekʼut, ri in, in kʼo pa nu>bʼaqil, e ri nu>bʼaqil kʼo pa ri u>kowinem ri makaj.
Ri jun che man kʼo ta ri loqʼoqʼebʼal ukʼuʼx, man retaʼm ta uwach riʼ ri Dyos, rumal rech che ri Dyos, xas loqʼoqʼebʼal kʼuʼx wi ri areʼ.	Ri jun ch>e man kʼo ta ri loqʼoqʼebʼal u>kʼuʼx, man r>etaʼm ta u>wach riʼ ri Dyos, r>umal rech ch>e ri Dyos, xas loqʼoqʼebʼal kʼuʼx wi ri areʼ.
Ri eʼajjudiʼo kkaj jujun taq kʼutbʼal, ri eʼajgriʼego kkaj ri etaʼmabʼal,	Ri eʼ>ajjudiʼo k>kaj jujun taq kʼutbʼal, ri eʼ>ajgriʼego k>kaj ri etaʼmabʼal,
Xepe le winaq xolkikʼama	X>e>pe le winaq x>ol>ki>kʼam>a
Xojkiʼkotik are~taq xatulik	X>oj>kiʼkot>ik are~taq x>at>ul>ik
Xinpe pa taqʼaj.	X>in>pe pa taqʼaj.
Xchʼajtaj qumal	X>chʼaj>taj q>umal
Xintoʼtaj che ri nuchak.	X>in>toʼtaj ch>e ri nu>chak.
che ojer kanoq, ri areʼ man kʼo ta upatan chawech, kʼatekʼut, kamik riʼ, nimalaj upatan chawech, jacha nimalaj upatan chwech ri in kamik riʼ.	ch>e ojer kan>oq, ri areʼ man kʼo ta u>patan ch>aw>ech, kʼatekʼut, kamik riʼ, nimalaj u>patan ch>aw>ech, jacha nimalaj u>patan ch>w>ech ri in kamik riʼ.
Pa ri jun qʼij chi apanoq, kʼo chi jumul ri Xwan chilaʼ, kukʼ ekebʼ eʼutijoxel.	Pa ri jun qʼij chi apan>oq, kʼo chi jumul ri Xwan chilaʼ, k>ukʼ e>kebʼ eʼ>u>tijoxel.
Jeʼ jas ri utat kkaʼyik.	Jeʼ jas ri u>tat k>kaʼy>ik.
Xokʼowisaxik pa ri Jerusalem ri nimaqʼij rech ri kʼakʼ Nim Rachoch ri Dyos. Sibʼalaj kʼax tew.	X>okʼowisa>x>ik pa ri Jerusalem ri nimaqʼij rech ri kʼakʼ Nim R>achoch ri Dyos. Sibʼalaj kʼax tew.
Ukaj takaniq (4).	Ukaj takaniq (4).
Yaʼtal chaqe qonojel ri uj winaq utz kaqil qibʼ. 	Yaʼtal ch>aq>e q>onojel ri uj winaq utz k>aqil q>ibʼ. 
«We eʼutz we jun ja kʼolbʼal riʼ, kopan ri nimalaj iwutzil pakiwiʼ ri eʼareʼ; we man eʼutz, ri nimalaj utzil kʼo iwukʼ ktzalej na riʼ piwiʼ.	«We eʼ>utz we jun ja kʼolbʼal riʼ, k>opan ri nimalaj iw>utzil pa>ki>wiʼ ri eʼareʼ; we man eʼ>utz, ri nimalaj utzil kʼo iw>ukʼ k>tzalej na riʼ p>i>wiʼ.
Kʼo lemoʼ chi wochoch.	Kʼo lemoʼ chi w>ochoch.
¿La man uj ujtzʼaqatil ta ri Ubʼaqil?	¿La man uj uj>tzʼaqatil ta ri U>bʼaqil?
Kʼax iwech ri ix, ri ix nojinaq kamik, rumal che kixnum na riʼ. Kʼax iwech ri ix, ri kixjaʼjat kamik, rumal che kixbʼison na e kixoqʼ na riʼ.	Kʼax iw>ech ri ix, ri ix nojinaq kamik, r>umal ch>e k>ix>num na riʼ. Kʼax iw>ech ri ix, ri k>ix>jaʼjat kamik, r>umal ch>e k>ix>bʼison na e k>ix>oqʼ na riʼ.
¿Jachin ri nimalaj uqʼijil? ¿La are ri kʼo cho ri mexa, on are ri kpatanajik? ¿La man are ta ri kʼo cho ri mexa? Ri in, in kʼo chixoʼl ri ix in jeriʼ jacha ri in patanijel kech ri enikʼaj chik!»	¿Jachin ri nimalaj u>qʼijil? ¿La are ri kʼo cho ri mexa, on are ri k>patanaj>ik? ¿La man are ta ri kʼo cho ri mexa? Ri in, in kʼo ch>i>xoʼl ri ix in jeriʼ jacha ri in patanijel k>ech ri e>nikʼaj chik!»
Wajxaqlajuj ujunabʼ ri numiʼal.	Wajxaqlajuj u>junabʼ ri nu>miʼal.
Ri tat Xwan potzʼ.	Ri tat Xwan potzʼ.
¡Chkʼojiʼ ta bʼaʼ iwukʼ iwonojel ri nimalaj sipanik!	¡Ch>kʼojiʼ ta bʼaʼ iw>ukʼ iw>onojel ri nimalaj sipanik!
Iwech chi jujunal, ri wa.	Iw>ech chi jujunal, ri wa.
xa su rajawixik wi chi kok uchuqʼabʼ ri ubʼantajik ri kikʼaslemal,	xa su rajawixik wi chi k>ok u>chuqʼabʼ ri u>bʼantajik ri ki>kʼaslemal,
Pa ri areʼ ronojel utz ja kkʼiyik, je kbʼantajik jun utzalaj tyox pa ri Ajawxel;	Pa ri areʼ r>onojel utz ja k>kʼiy>ik, je k>bʼantajik jun utzalaj tyox pa ri Ajawxel;
kilitaj waʼ are kinoʼj winaq keʼpe chʼaqap.	k>ilitaj waʼ are ki>noʼj winaq k>eʼ>pe chʼaqap.
Kchʼetet ri jaʼ.	K>chʼetet ri jaʼ.
che xmuqik, che xkʼastaj uwach pa ri urox qʼij jacha ri tzʼibʼatalik,	ch>e x>muq>ik, ch>e x>kʼastaj u>wach pa ri urox qʼij jacha ri tzʼibʼatalik,
Xojʼek xeʼqilala rqasok	X>oj>ʼe>k x>eʼ>q>il>a>la r>qa>sok
Utz le nuqʼabʼ	Utz le nu>qʼabʼ
Qawuj	Qa>wuj
aretaq chiʼ majaʼ kʼo ri Pixabʼ, xas kʼo chi wi ri makaj pa ri uwachulew, kʼatekʼuriʼ ri makaj man kʼo ta kil apanoq aretaq chiʼ majaʼ kʼo jun pixabʼ;	aretaq chiʼ majaʼ kʼo ri Pixabʼ, xas kʼo chi wi ri makaj pa ri uwachulew, kʼatekʼuriʼ ri makaj man kʼo ta k>il apan>oq aretaq chiʼ majaʼ kʼo jun pixabʼ;
Pa ronojel kʼolibʼal chixmaltyoxin chrech ri Dyos. Are waʼ ri urayibʼal ri Dyos chiwech pa ri Kristo Jesus.	Pa r>onojel kʼolibʼal ch>ix>maltyoxin ch>r>ech ri Dyos. Are waʼ ri u>rayibʼal ri Dyos ch>iw>ech pa ri Kristo Jesus.
Jas xaqʼiʼo xatijo	Jas x>a>qʼiʼ>o x>a>tij>o
Kjoror ri qʼij.	K>joror ri qʼij.
La xeʼe kʼu la xeʼkijaqa kʼu le uchi ja	La x>e>ʼe kʼu la x>eʼ>ki>jaq>a kʼu le u>chi ja
Bʼelejebʼ qʼataj. Kilixik.	Bʼelejebʼ qʼataj. K>ili>x>ik.
Kʼatekʼut, xinbʼe pa ri Siriʼa e pa ri Silisiʼa;	Kʼatekʼut, x>in>bʼe pa ri Siriʼa e pa ri Silisiʼa;
Ri numam are kʼo uqʼinomal.	Ri nu>mam are kʼo u>qʼinomal.
xane xas tzʼibʼatalik puwiʼ ri uwuq qʼij: kʼatekʼuriʼ, ri Dyos, xuxlanik pa ri uwuq qʼij che ronojel taq ri uchak.	xane xas tzʼibʼatalik p>u>wiʼ ri uwuq qʼij: kʼatekʼuriʼ, ri Dyos, x>uxlan>ik pa ri uwuq qʼij ch>e r>onojel taq ri u>chak.
ke ri ajtijoxelabʼ, kabʼe wi.	k>e ri ajtijoxel>abʼ, ka>bʼe wi.
Xqʼatan ri par.	X>qʼatan ri par.
Ri ixoq ri xpe Chwitzʼaq xulik	Ri ixoq ri x>pe Chwitzʼaq x>ul>ik
La katʼe kʼut kabʼij?	La k>at>ʼe kʼut k>a>bʼi>j?
Na xwaj ta chik xinbʼij	Na x>w>aj ta chik x>in>bʼi>j
kʼatekʼuriʼ, sibʼalaj nim kekojon chrech ri areʼ, rumal ri utzij,	kʼatekʼuriʼ, sibʼalaj nim k>e>kojon ch>r>ech ri areʼ, r>umal ri u>tzij,
Ri ekʼo pa ri Judeʼa, xaqbʼiʼ cheʼanimajoq ubʼi pa taq ri juyubʼ. Ri ekʼo pa ri tinamit cheʼel uloq chilaʼ. Ri ekʼo pa taq ri tikonbʼal, meʼok chi pa ri tinamit.	Ri ekʼo pa ri Judeʼa, xaqbʼiʼ ch>eʼ>animaj>oq u>bʼi pa taq ri juyubʼ. Ri ekʼo pa ri tinamit ch>eʼ>el uloq chilaʼ. Ri ekʼo pa taq ri tikonbʼal, m>eʼ>ok chi pa ri tinamit.
We kʼo ri kechbʼal rumal rech ri Pixabʼ, man utz ta na kʼuriʼ ri kojonik e ri chiʼnik	We kʼo ri k>echbʼal r>umal rech ri Pixabʼ, man utz ta na kʼuriʼ ri kojonik e ri chiʼnik
Na xeʼe taj na xeʼkiqʼatuj taj	Na x>e>ʼe taj na x>eʼ>ki>qʼatu>j taj
Kebʼe pa ri Pisidiʼa e keʼok pa ri Panfiliʼa.	K>e>bʼe pa ri Pisidiʼa e k>eʼ>ok pa ri Panfiliʼa.
Xuqʼiʼo are le ukʼulel	X>u>qʼiʼ>o are le u>kʼulel
Xintzaq nulawe.	X>in>tzaq nu>lawe.
Ri areʼ, are tabʼal toqʼobʼ chuwach taq ri qamak, man xuwi ta chuwach ri qamak uj xane xoqujeʼ chuwach ri kimak kech konojel ri uwachulew.	Ri areʼ, are tabʼal toqʼobʼ ch>u>wach taq ri qa>mak, man xuwi ta ch>u>wach ri qa>mak uj xane xoqujeʼ ch>u>wach ri ki>mak k>ech k>onojel ri uwachulew.
Xojpixabʼanik	X>oj>pixabʼa>n>ik
Ri tʼuʼy kpaqʼowik.	Ri tʼuʼy k>paqʼ>ow>ik.
I xumin ruʼjolom riʼ rtzʼiʼ i na xtzoqopitaj ta chuʼloq .	I x>u>min r>uʼ>jolom riʼ r>tzʼiʼ i na x>tzoqopi>taj ta ch>uʼloq .
Xoqujeʼ aretaq chiʼ kiwil na ri ix weriʼ, iwetaʼm che ri Rajawibʼal ri Dyos naqaj chik kʼo wi.	Xoqujeʼ aretaq chiʼ ki>wil na ri ix weriʼ, iw>etaʼm ch>e ri R>ajawibʼal ri Dyos naqaj chik kʼo wi.
Riʼ ri kebʼ nimaq taq ral ri ixoq riʼ.	Riʼ ri kebʼ nim>aq taq r>al ri ixoq riʼ.
areʼ:.	areʼ:.
Ri Pabʼlo, Apostol rech ri Kristo Jesus rumal ri urayibʼal ri Dyos; e ri Timoteʼo che jun achalaxik; chrech ri Ukomon Tyox ri Dyos che kʼo pa ri Korinto e chkech konojel ri etyoxlaj taq winaq pa ronojel ri Akaya;	Ri Pabʼlo, Apostol rech ri Kristo Jesus r>umal ri u>rayibʼal ri Dyos; e ri Timoteʼo ch>e jun achalaxik; ch>r>ech ri U>komon Tyox ri Dyos ch>e kʼo pa ri Korinto e ch>k>ech k>onojel ri e>tyoxlaj taq winaq pa r>onojel ri Akaya;
–“¡Ajawxel, kecha chrech, ri areʼ kʼo chi lajuj qʼan pwaq rukʼ!”…	–“¡Ajawxel, k>e>cha ch>r>ech, ri areʼ kʼo chi lajuj qʼan pwaq r>ukʼ!”…
Petinaq chik ri Qʼaxebʼal (Paskuʼa) ri nimaqʼij kech ri ajjudiʼo.	Petinaq chik ri Qʼaxebʼal (Paskuʼa) ri nimaqʼij k>ech ri ajjudiʼo.
Latzʼ uwach ri bʼe.	Latzʼ u>wach ri bʼe.
Achi xatwilo	Achi x>at>w>il>o
Xubʼij chwe jawi kʼow kanoq	X>u>bʼi>j ch>w>e jawi kʼo>w kanoq
Xujbʼe pa jun kʼulanem.	X>uj>bʼe pa jun kʼulanem.
kʼo ta kichak; xuqujeʼ jun kʼax.	kʼo ta ki>chak; xuqujeʼ jun kʼax.
ta pa ri 1999.	ta pa ri 1999.
Noʼjim chak wumal	Noʼjim chak w>umal
Ri nim chuchqajaw kuta chrech: «¿La tzij we tzij riʼ?».	Ri nim chuchqajaw kut>a ch>r>ech: «¿La tzij we tzij riʼ?».
Ri ubʼantajik jun apostol xas xbʼantajik wi chixoʼl wi ri ix: tzʼaqatalaj chuqʼabʼ pa taq ri kʼax, xoqujeʼ xbʼantajik pa taq ri kʼutbʼal e pa taq ri mayibʼal.	Ri u>bʼantajik jun apostol xas x>bʼan>taj>ik wi ch>i>xoʼl wi ri ix: tzʼaqat>alaj chuqʼabʼ pa taq ri kʼax, xoqujeʼ x>bʼan>taj>ik pa taq ri kʼutbʼal e pa taq ri mayibʼal.
Jeʼl kkaʼy ri ali	Jeʼl k>kaʼy ri ali
Kbʼe utzijol we jastaq riʼ pa ronojel ri rulew ri Galileʼa.	K>bʼe u>tzijol we jastaq riʼ pa r>onojel ri r>ulew ri Galileʼa.
Ri watiʼt ubʼiʼ Roʼs.	Ri w>atiʼt u>bʼiʼ Roʼs.
¿Suche kpe uloq wukʼ ri in, ri unan ri Wajawxel?	¿Suche k>pe uloq w>ukʼ ri in, ri u>nan ri W>ajawxel?
Juwinaq bʼelejebʼ qʼataj.	Juwinaq bʼelejebʼ qʼataj.
La xatok kʼu chi ratinsaxik awibʼ?	La x>at>ok kʼu chi r>atinsa>x>ik aw>ibʼ?
kʼatekʼuriʼ xemaltyoxin chrech ri Dyos wumal ri in.	kʼatekʼuriʼ x>e>maltyoxin ch>r>ech ri Dyos w>umal ri in.
Ri ix, ix ilol rech e ix tal rech weriʼ.	Ri ix, ix ilol rech e ix tal rech weriʼ.
¿Jampaʼ kujbʼe pa nimaqʼij?	¿Jampaʼ k>uj>bʼe pa nimaqʼij?
Kʼatekʼuriʼ chi rajawaxik wi kqʼax pa ri Samariʼa.	Kʼatekʼuriʼ chi rajawaxik wi k>qʼax pa ri Samariʼa.
Ri Pabʼlo, Apostol rech ri Jesus Kristo, rumal ri utaqanik ri Dyos Qakolonel e rumal ri Kristo Jesus che qeyeʼbʼal,	Ri Pabʼlo, Apostol rech ri Jesus Kristo, r>umal ri u>taqanik ri Dyos Qa>kolonel e r>umal ri Kristo Jesus ch>e q>eyeʼbʼal,
Mawilo	M>aw>il>o
Ri nabʼe winaq, che kel ubʼi pa ri ulew, ri areʼ, rech ri uwachulew, ri ukabʼ, kpe chi pa ri kaj.	Ri nabʼe winaq, ch>e k>el u>bʼi pa ri ulew, ri areʼ, rech ri uwachulew, ri ukabʼ, k>pe chi pa ri kaj.
Xukʼaq bʼi jun abʼaj rech kixkil loq	X>u>kʼaq bʼi jun abʼaj r>ech k>ix>k>il loq
Ktijow ri utiʼjolal ri ixpum.	K>tijow ri u>tiʼjolal ri ix>pum.
Sibʼalaj kinkiʼkotik rumal rech xepetik ri Estefanas, ri Fortunato e ri Akaʼiko aretaq chiʼ ixelenaq ubʼik ri ix.	Sibʼalaj k>in>kiʼkot>ik r>umal rech x>e>pet>ik ri Estefanas, ri Fortunato e ri Akaʼiko aretaq chiʼ ix>elenaq ubʼik ri ix.
Ri Luʼ e ri Xwan kepe uloq pa ri Nim Rachoch ri Dyos chuxeʼ kan ri chʼawem rukʼ ri Dyos pa ri bʼelejebʼ kajbʼal.	Ri Luʼ e ri Xwan k>e>pe uloq pa ri Nim R>achoch ri Dyos ch>u>xeʼ kan ri chʼawem r>ukʼ ri Dyos pa ri bʼelejebʼ kajbʼal.
Noʼjim ta bʼa kakikʼoxomaj	Noʼjim ta bʼa ka>ki>kʼoxoma>j
ri winaq pa ri re wi ri areʼ.	ri winaq pa ri r>e wi ri areʼ.
Ajilanel uchak areʼ.	Ajilanel u>chak areʼ.
¿Jas ujunamtajil ri Kristo rukʼ ri Bʼeliʼar? ¿Jas ujunamtajil ri kkojonik rukʼ ri man kkojon taj?	¿Jas u>junamtajil ri Kristo r>ukʼ ri Bʼeliʼar? ¿Jas u>junamtajil ri k>kojonik r>ukʼ ri man k>kojon taj?
kʼatekʼuriʼ, ma kbʼix ta na: “¡Kʼolik waral!”. “¡Kʼolik jelaʼ!”, rumal rech che ri Rajawibʼal ri Dyos kʼo chik chixoʼl ri ix».	kʼatekʼuriʼ, ma k>bʼix ta na: “¡Kʼolik waral!”. “¡Kʼolik jelaʼ!”, r>umal rech ch>e ri R>ajawibʼal ri Dyos kʼo chik ch>i>xoʼl ri ix».
Ukabʼ taqanik (2).	Ukabʼ taqanik (2).
We kʼo jun ralkʼuwaʼl ri nimalaj utzil chilaʼ, ri nimalaj iwutzil kuxlan na riʼ puwiʼ ri areʼ, we man kʼo taj, ktzalij na riʼ iwukʼ.	We kʼo jun r>alkʼuwaʼl ri nimalaj utzil chilaʼ, ri nimalaj iw>utzil k>uxlan na riʼ p>u>wiʼ ri areʼ, we man kʼo taj, k>tzalij na riʼ iw>ukʼ.
Juwinaq lajuj qʼataj.	Juwinaq lajuj qʼataj.
tinimit.	tinimit.
Ri rajaw rulew areʼ tat Kel.	Ri r>ajaw r>ulew areʼ tat K>el.
Kʼo jun qʼoxowem chi we.	Kʼo jun qʼoxowem chi we.
Ix achalaxik, ri usipanik ri Qajawxel Jesus Kristo, chkanaj kan bʼaʼ pa ri iwuxlabʼal ¡Amen!	Ix achalaxik, ri u>sipanik ri Q>ajawxel Jesus Kristo, ch>kanaj kan bʼaʼ pa ri iw>uxlabʼal ¡Amen!
Noʼjimal ukemik le pas awumal	Noʼjimal u>kem>ik le pas aw>umal
Ri wachalal xuloqʼ ulew.	Ri w>achalal x>ul>oqʼ ulew.
«Ri ix, jeriʼ bʼaʼ chixchʼaw rukʼ ri Dyos: Qatat, ri at kʼo chikaj, tyoxlaj ri abʼiʼ,	«Ri ix, jeriʼ bʼaʼ ch>ix>chʼaw r>ukʼ ri Dyos: Qa>tat, ri at kʼo chikaj, tyoxlaj ri a>bʼiʼ,
Ri eʼachalaxik enojinaq chrech ri kiʼkotemal e chrech ri Tyoxlaj Uxlabʼxel.	Ri eʼ>achalaxik e>nojinaq ch>r>ech ri kiʼkotemal e ch>r>ech ri Tyoxlaj Uxlabʼxel.
Na xnaʼtaj ta chke chi xeatinik	Na x>naʼtaj ta ch>k>e chi x>e>atin>ik
Noʼjim ukemik le pas awumal	Noʼjim u>kem>ik le pas aw>umal
Katʼek xinta	K>at>ʼe>k x>in>ta
Ri wixnam xkäm pa ri lajuj Qʼanil.	Ri w>ixnam x>käm pa ri lajuj Qʼanil.
Xixiujsikʼij ulo chi iqilik	X>ixi>uj>sikʼi>j ulo chi iq>il>ik
«In ri in qas ucheʼal uva e are ri Nutat ri ajchak pa ri ulew.	«In ri in qas u>cheʼal uva e are ri Nu>tat ri ajchak pa ri ulew.
Na xkikamsaj taj xkikʼam bʼi choja	Na x>ki>kamsa>j taj x>ki>kʼam bʼi ch>o>ja
chike pa nikʼaj tinimit chik, pacha ri chomanik pa kiwiʼ ri rajawixik	chi>k>e pa nikʼaj tinimit chik, pacha ri chomanik pa ki>wiʼ ri rajawixik
Xojbʼinik	X>oj>bʼin>ik
Ri efariseʼo, xoqujeʼ ejujun ajtzʼibʼanelabʼ epetinaq uloq chi pa ri Jerusalem, keqibʼ ukoq rukʼ.	Ri e>fariseʼo, xoqujeʼ e>jujun ajtzʼibʼanel>abʼ e>petinaq uloq chi pa ri Jerusalem, k>e>qibʼ uk>oq r>ukʼ.
Xinqʼiʼo takʼalik xinpetik	X>in>qʼiʼ>o takʼ>al>ik x>in>pet>ik
Uwajxaq taqanik (8).	Uwajxaq taqanik (8).
Ri yabʼil wareʼaj are jun yabʼil pa qachiʼ.	Ri yabʼil wareʼ>aj are jun yabʼil pa qa>chiʼ.
Xa jekʼuriʼ, tyoxlaj ri Pixabʼ e tyoxlaj ri taqanik, sibʼalaj sukʼ e sibʼalaj utz.	Xa jekʼuriʼ, tyoxlaj ri Pixabʼ e tyoxlaj ri taqanik, sibʼalaj sukʼ e sibʼalaj utz.
Ri Utzij ri Ajawxel xbʼe utzijol pa ronojel ri jetaq tinimit.	Ri U>tzij ri Ajawxel x>bʼe u>tzijol pa r>onojel ri jetaq tinimit.
Ronojel taq waʼ we tojbʼalil are ri qʼatbʼal tzij kqʼatowik.	R>onojel taq waʼ we tojbʼalil are ri qʼatbʼal tzij k>qʼat>ow>ik.
Amaqʼel kinnumik.	Amaqʼel k>in>num>ik.
Pusum ri kaxlaʼn wa wa.	Pusum ri kaxlaʼn wa wa.
Säq uwiʼ ri numam.	Säq u>wiʼ ri nu>mam.
tinimit	tinimit
Kʼo jun achi, Sakeʼo ri ubʼiʼ, jun nim reqleʼn winaq, kʼamal bʼe chkech ri eʼajtoqʼinel pwaq, xoqujeʼ sibʼalaj qʼinom.	Kʼo jun achi, Sakeʼo ri u>bʼiʼ, jun nim r>eqleʼn winaq, kʼamal bʼe ch>k>ech ri eʼ>ajtoqʼinel pwaq, xoqujeʼ sibʼalaj qʼinom.
E nukej.	E nu>kej.
Kasumum ri kaqiqʼ.	Ka>sumum ri kaqiqʼ.
Aretaq chiʼ ri in, in kʼo chuwachulew, in saqil rech ri uwachulew».	Aretaq chiʼ ri in, in kʼo ch>uwachulew, in saqil rech ri uwachulew».
¿On ri Dyos xuwi Dyos chkech ri eʼajjudiʼo e man Dyos ta chkech ri man eʼajjudiʼo taj? Jeʼ nakʼut, ri Dyos, xoqujeʼ Kidyos ri man eʼajjudiʼo taj;	¿On ri Dyos xuwi Dyos ch>k>ech ri eʼ>ajjudiʼo e man Dyos ta ch>k>ech ri man eʼ>ajjudiʼo taj? Jeʼ nakʼut, ri Dyos, xoqujeʼ Ki>dyos ri man eʼ>ajjudiʼo taj;
Ri Pabʼlo, che sikʼim arech kuxik utaqoʼn ri Kristo Jesus rumal ri urayibʼal ri Dyos e rumal ri Sostenes che qachalal,	Ri Pabʼlo, ch>e sikʼim arech k>ux>ik u>taqoʼn ri Kristo Jesus r>umal ri u>rayibʼal ri Dyos e r>umal ri Sostenes ch>e q>achalal,
winaq keʼpe naj	winaq k>eʼ>pe naj
Ri alaxinaq pa ri bʼaqilal, bʼaqilal riʼ, ri alaxinaq pa ri Uxlabʼxel, uxlabʼal riʼ.	Ri alaxinaq pa ri bʼaqilal, bʼaqilal riʼ, ri alaxinaq pa ri Uxlabʼxel, uxlabʼal riʼ.
Xkilo chi na kinkʼoxomaj taj	X>k>il>o chi na k>in>kʼoxoma>j taj
Tajin kchʼaw na chkech ri winaq, aretaq chiʼ ri unan e ri erachalal keʼopan chilaʼ, kʼatekʼuriʼ kkaj kechʼaw rukʼ ri areʼ.	Tajin k>chʼaw na ch>k>ech ri winaq, aretaq chiʼ ri u>nan e ri e>r>achalal k>eʼ>opan chilaʼ, kʼatekʼuriʼ k>kaj k>e>chʼaw r>ukʼ ri areʼ.
Jas xojʼe chuloqʼik ?	Jas x>oj>ʼe ch>u>loqʼ>ik ?
kʼi taq ri chak, kʼatekʼut xa jun chi Dyos che kchakun pa ronojel winaq.	kʼi taq ri chak, kʼatekʼut xa jun chi Dyos ch>e k>chakun pa r>onojel winaq.
Ri 6 	Ri 6 
kibʼantajik ri winaq.	ki>bʼantajik ri winaq.
Juwinaq kajibʼ.	Juwinaq kajibʼ.
Pa ri jaʼ kakʼojiʼ wi ri ixtutzʼ.	Pa ri jaʼ ka>kʼojiʼ wi ri ixtutzʼ.
Qilik	Q>il>ik
jun chi Ajawxel, jun chi qakojonik, jun chi qaqasnaʼ,	jun chi Ajawxel, jun chi qa>kojonik, jun chi qa>qasnaʼ,
junam ri kabʼanik.	junam ri ka>bʼan>ik.
Xujkʼojiʼ chi uchiʼ ri cho.	X>uj>kʼojiʼ chi u>chiʼ ri cho.
Rumal kʼuwaʼ weriʼ, pa ronojel mul man yaʼtal ta chwech arech ri in kinbʼe pa ri itinimit.	R>umal kʼuwaʼ weriʼ, pa r>onojel mul man yaʼtal ta ch>w>ech arech ri in k>in>bʼe pa ri i>tinimit.
kʼatekʼuriʼ: Ri Ajawxel, retaʼm ri kichomabʼal ri enim taq ketaʼmabʼal winaq; retaʼm che man kʼo ta uchoqʼabʼ we kichomabʼal riʼ.	kʼatekʼuriʼ: Ri Ajawxel, r>etaʼm ri ki>chomabʼal ri e>nim taq k>etaʼmabʼal winaq; r>etaʼm ch>e man kʼo ta u>choqʼabʼ we ki>chomabʼal riʼ.
Rajawxik kpaqʼ ronojel ri cheʼ.	Rajawxik k>paqʼ r>onojel ri cheʼ.
rumal rech, che ri ix kʼo ri iweyeʼbʼal chilaʼ chikaj. E chrech we eyeʼbʼal riʼ, ri ix xixtijoxik rumal ri utzij ri saqalaj tzij, che are ri Utzalaj Tzij,	r>umal rech, ch>e ri ix kʼo ri iw>eyeʼbʼal chilaʼ chikaj. E ch>r>ech we eyeʼbʼal riʼ, ri ix x>ix>tijo>x>ik r>umal ri u>tzij ri saqalaj tzij, ch>e are ri Utzalaj Tzij,
ri kʼax).	ri kʼax).
Ri Mariʼy oxibʼ ikʼ kkanaj rukʼ ri areʼ, kʼatekʼuriʼ ktzalej pa ri rachoch.	Ri Mariʼy oxibʼ ikʼ k>kanaj r>ukʼ ri areʼ, kʼatekʼuriʼ k>tzalej pa ri r>achoch.
Kujel ubʼi pa jun kukubʼ rech ri Troʼada, e kujbʼe pa ri Samotrasiʼa, e pa ri jun qʼij chik kujbʼe pa ri Neʼapolis,	K>uj>el u>bʼi pa jun kukubʼ rech ri Troʼada, e k>uj>bʼe pa ri Samotrasiʼa, e pa ri jun qʼij chik k>uj>bʼe pa ri Neʼapolis,
Xnaʼtaj waʼim chwe	X>naʼtaj waʼ>im ch>w>e
We kʼo ri Uxlabʼxel iwukʼ ri ix, ri ix, man ix kʼo ta riʼ chuxeʼ ri pixabʼ.	We kʼo ri Uxlabʼxel iw>ukʼ ri ix, ri ix, man ix kʼo ta riʼ ch>u>xeʼ ri pixabʼ.
wi.	wi.
tinamit?.	tinamit?.
Retaʼm uwach jachin xloqʼow ri pas.	R>etaʼm u>wach jachin x>loqʼow ri pas.
Na xwaj taj xinbʼij	Na x>w>a>j taj x>in>bʼi>j
Xinpaj ri nutriko.	X>in>paj ri nu>triko.
Xinta chi katulik	X>in>ta chi k>at>ul>ik
Na xwaj taj xinchʼawik	Na x>w>aj taj x>in>chʼaw>ik
Kinwaʼik rech na kinyowaj taj	K>in>waʼ>ik r>ech na k>in>yowaj taj
Jawi xsachon wi kan uyaʼik le pwaq che	Jawi x>sachon wi kan u>yaʼ>ik le pwaq ch>e
Ri qatinamit laj chech unimal rulewal.	Ri qa>tinamit laj ch>ech u>nimal r>ulewal.
«Ri ix, itom che kbʼixik: Matmakunik rukʼ ixoq achi.	«Ri ix, i>tom ch>e k>bʼixik: M>at>makun>ik r>ukʼ ixoq achi.
Kwaʼlaj ri polow rumal rech che kajumumik jun nimalaj kyaqiqʼ.	K>waʼlaj ri polow r>umal rech ch>e ka>jumum>ik jun nimalaj kyaqiqʼ.
Kʼatekʼuriʼ aretaq chiʼ kkʼiy na ri itzel, sibʼalaj ewinaq riʼ kjorobʼik ri loqʼoqʼebʼal kikʼuʼx.	Kʼatekʼuriʼ aretaq chiʼ k>kʼiy na ri itzel, sibʼalaj e>winaq riʼ k>jorobʼ>ik ri loqʼoqʼebʼal ki>kʼuʼx.
E kʼo pa Jerusalem, enikʼaj etyoxlaj taq winaq che epetinaq chi pa ronojel tinimit che kʼo chuxeʼ ri kaj.	E kʼo pa Jerusalem, e>nikʼaj e>tyoxlaj taq winaq ch>e e>petinaq chi pa r>onojel tinimit ch>e kʼo ch>u>xeʼ ri kaj.
Kawinaq wajxaqibʼ.	Kawinaq wajxaqibʼ.
Bolivia (2002)	Bolivia (2002)
Nojim katwaʼik.	Nojim k>at>waʼ>ik.
winaq.	winaq.
che pa ri areʼ kʼo wi ri qakolotajem e ri sachibʼal qamak.	ch>e pa ri areʼ kʼo wi ri qa>kolotajem e ri sachibʼal qa>mak.
ri winaq chi rajawixik chi ke.	ri winaq chi rajawixik chi k>e.
Chsikʼa ri muchuʼl.	Ch>sikʼ>a ri muchuʼl.
Maʼtam xatpe che ri waʼim.	Maʼtam x>at>pe ch>e ri waʼim.
E kʼi ri ixoqibʼ e kʼo pa ri malkaʼnil.	E kʼi ri ixoq>ibʼ e kʼo pa ri malkaʼnil.
Xqata chi xatulik	X>qa>ta chi x>at>ul>ik
Xqaxiʼj qibʼ xqachapo	X>qa>xiʼj q>ibʼ x>qa>chap>o
Xinbʼisonik taq na xatpet taj	X>in>bʼison>ik taq na x>at>pet taj
Xinta jachin xulik	X>in>ta jachin x>ul>ik
konojel ri winaq.	k>onojel ri winaq.
Kʼatekʼuriʼ, chilaʼ riʼ, ekʼi kekojon chrech ri areʼ.	Kʼatekʼuriʼ, chilaʼ riʼ, ekʼi k>e>kojon ch>r>ech ri areʼ.
chiwech iwonojel ri ix, ri ix loqʼalaj taq rech ri Dyos pa ri Roma, chiwech ri ix, che ix tyoxlaj taq winaq rumal rech che xixsikʼixik; chiwech bʼaʼ ri ix ri nimalaj ubʼantajik usipanik ri Dyos e ri nimalaj utzil, rumal ri Dyos ri Qatatxel e rumal ri Ajawxel Jesus Kristo.	ch>iw>ech iw>onojel ri ix, ri ix loqʼalaj taq rech ri Dyos pa ri Roma, ch>iw>ech ri ix, ch>e ix tyoxlaj taq winaq r>umal rech ch>e x>ix>sikʼix>ik; ch>iw>ech bʼaʼ ri ix ri nimalaj u>bʼantajik u>sipanik ri Dyos e ri nimalaj utzil, r>umal ri Dyos ri Qa>tatxel e r>umal ri Ajawxel Jesus Kristo.
Chu chu ri par.	Chu chu ri par.
Xqatijo	X>qa>tij>o
«Ri tijoxel, man are ta nim chuwach ri rajtij, e ri pataninel man are ta nim chuwach ri rajaw.	«Ri tijoxel, man are ta nim ch>u>wach ri r>ajtij, e ri pataninel man are ta nim ch>u>wach ri r>ajaw.
ri kʼo ri utzij qʼatbʼaltzij chech, xuqujeʼ jawi ma kʼo ta chi kʼax kabʼanik.	ri kʼo ri u>tzij qʼatbʼaltzij ch>ech, xuqujeʼ jawi ma kʼo ta chi kʼax ka>bʼan>ik.
Rumal kʼu waʼ weriʼ, we jun ulew riʼ kbʼix chrech: «rulew ukikʼel winaq», xoqujeʼ chi kbʼix na kamik riʼ.	R>umal kʼu waʼ weriʼ, we jun ulew riʼ k>bʼix ch>r>ech: «r>ulew u>kikʼel winaq», xoqujeʼ chi k>bʼix na kamik riʼ.
Kʼatekʼut, we yawabʼ ri awoqʼoch, ronojel riʼ ri abʼaqil kʼo pa qʼequʼmal. We qʼequʼm ri chäj kʼo awukʼ, ¡sibʼalaj jun qʼequʼm riʼ kʼolik!	Kʼatekʼut, we yawabʼ ri a>woqʼoch, r>onojel riʼ ri a>bʼaqil kʼo pa qʼequʼmal. We qʼequʼm ri chäj kʼo aw>ukʼ, ¡sibʼalaj jun qʼequʼm riʼ kʼol>ik!
Aretaq chiʼ kqʼax ri nimaqʼij, ketzalij uloq. Ri alaj Jesus kkanaj kan pa ri Jerusalem, kʼatekʼuriʼ, ri unan utat man ketaʼm taj.	Aretaq chiʼ k>qʼax ri nimaqʼij, k>e>tzalij uloq. Ri alaj Jesus k>kanaj kan pa ri Jerusalem, kʼatekʼuriʼ, ri u>nan u>tat man k>etaʼm taj.
Pa Tujal kkʼiy ri jeʼlik qʼinom.	Pa Tujal k>kʼiy ri jeʼl>ik qʼinom.
Kʼatekʼuriʼ, ixloqʼalaj taq achalaxik, ri ix ix nukiʼkotemal, ri ix ix utojbʼalil nuchak; chkʼojiʼ bʼaʼ ichuqʼabʼ pa ri Ajawxel, ixloqʼalaj taq achalaxik.	Kʼatekʼuriʼ, ix>loqʼalaj taq achalaxik, ri ix ix nu>kiʼkotemal, ri ix ix u>tojbʼalil nu>chak; ch>kʼojiʼ bʼaʼ i>chuqʼabʼ pa ri Ajawxel, ix>loqʼalaj taq achalaxik.
Rumal rech xopan ri Nimalaj Uqʼij ri royowal e ¿jachin kkowin riʼ che kkanaj kanoq chuwach?	R>umal rech x>opan ri Nimalaj U>qʼij ri r>oyowal e ¿jachin k>kowin riʼ ch>e k>kanaj kan>oq ch>u>wach?
ri ukojik riʼ.	ri u>kojik riʼ.
kipam.	ki>pam.
Xoqujeʼ ekʼo bʼaqilal rech ri kaj e ekʼo bʼaqilal rech ri uwachulew, kʼatekʼut jun riʼ ri kiqʼijil ri ebʼaqilal rech ri kaj e jun chi riʼ ri kiqʼijil ri bʼaqilal rech ri uwachulew.	Xoqujeʼ ekʼo bʼaqilal rech ri kaj e ekʼo bʼaqilal rech ri uwachulew, kʼatekʼut jun riʼ ri ki>qʼijil ri e>bʼaqilal rech ri kaj e jun chi riʼ ri ki>qʼijil ri bʼaqilal rech ri uwachulew.
Xkʼotochin chi kiwach chi kojalwoʼqa kukʼ	X>kʼotochin chi ki>wach chi k>oj>al>woʼ>qa k>ukʼ
Xojkitʼuyubʼaʼ rech kixqatatabʼej	X>oj>ki>tʼuy>ubʼaʼ r>ech k>ix>qa>tatabʼe>j
wa qatinimit Iximulew.	wa qa>tinimit Iximulew.
Xa jekʼuriʼ, konojel riʼ ketzayixik na rukʼ ri qʼaqʼ.	Xa jekʼuriʼ, k>onojel riʼ k>e>tzayi>x>ik na r>ukʼ ri qʼaqʼ.
Jeʼlik, we akej.	Jeʼl>ik, we a>kej.
Säq rij ri nukej.	Säq r>ij ri nu>kej.
Ekʼi chkech ri eʼareʼ kekojonik, xoqujeʼ ri ekinimal ri ixoqibʼ che eʼajgriʼego, e ejujun taq achijabʼ.	Ekʼi ch>k>ech ri eʼareʼ k>e>kojon>ik, xoqujeʼ ri e>ki>nimal ri ixoq>ibʼ ch>e eʼ>ajgriʼego, e e>jujun taq achij>abʼ.
Ri wakäx rech ri Luʼs.	Ri wakäx rech ri Luʼs.
Puchʼ na ri äj. 4 8	Puchʼ na ri äj. 4 8
Jas xukʼam bʼi  le tzʼiʼ xawilo?	Jas x>u>kʼam bʼi  le tzʼiʼ x>aw>il>o?
Xnaʼtaj chke xatkisikʼij	X>naʼtaj ch>k>e x>at>ki>sikʼi>j
Ri Luʼs waʼkatel.	Ri Luʼs waʼkatel.
tinimit chi kabʼanik.	tinimit chi ka>bʼan>ik.
Kʼo ri jaʼmaril pa ri qachoch.	Kʼo ri jaʼmaril pa ri q>achoch.
E... in kawaj katzjoj b'i la chwe	E... in k>aw>a>j ka>tzjo>j b'i la ch>w>e
Kʼo chilaʼ, jun achi, che juwinaq wajxaqlajuj chi junabʼ yawabʼ ri areʼ.	Kʼo chilaʼ, jun achi, ch>e juwinaq wajxaqlajuj chi junabʼ yawabʼ ri areʼ.
Okem tzij	Okem tzij
ri tikonbʼal are ri uwachulew; ri utz ijaʼ eʼareʼ ri eralkʼuwaʼl ri ajawibʼal; ri itzel qʼayes eʼareʼ ri eralkʼuwaʼl ri Itzel;	ri tikonbʼal are ri uwachulew; ri utz i>jaʼ eʼareʼ ri e>r>alkʼuwaʼl ri ajawibʼal; ri itzel qʼayes eʼareʼ ri e>r>alkʼuwaʼl ri Itzel;
Ulajuj taqanik (10).	Ulajuj taqanik (10).
kʼo ri kiʼkotemal awukʼ.	kʼo ri kiʼkotemal aw>ukʼ.
¡Man je ta riʼ, xaneʼ kixbʼe chkiwach ri eqʼatbʼaltzij e kixchʼoʼjinik jun achalaxik rukʼ jun achalaxik chik, e weriʼ, chkiwach ri winaq che man junam ta qakojonik kukʼ!	¡Man je ta riʼ, xaneʼ k>ix>bʼe ch>ki>wach ri e>qʼatbʼaltzij e k>ix>chʼoʼjin>ik jun achalaxik r>ukʼ jun achalaxik chik, e weriʼ, ch>ki>wach ri winaq ch>e man junam ta qa>kojonik k>ukʼ!
Kʼakʼ ri achʼichʼ.	Kʼakʼ ri a>chʼichʼ.
Areʼ retaʼm che kinopanik.	Areʼ r>etaʼm ch>e k>in>opan>ik.
Ri jun che kmakunik xoqujeʼ kmakunik pa ri itzel, rumal rech che itzel ri makaj.	Ri jun ch>e k>makun>ik xoqujeʼ k>makun>ik pa ri itzel, r>umal rech ch>e itzel ri makaj.
Kamik man kinbʼe ta chi uwach ri ja.	Kamik man k>in>bʼe ta chi u>wach ri ja.
Xojpetik xolqakʼamaʼ	X>oj>pet>ik x>ol>qa>kʼam>aʼ
Kwaʼ chi uwach le taqʼaj ri amaʼ äkʼ.	K>waʼ chi u>wach le taqʼaj ri amaʼ äkʼ.
arech qastzij kbʼantajik ri utzij ri Isaʼiʼas qʼaxel utzij ri Dyos:	arech qastzij k>bʼantajik ri u>tzij ri Isaʼiʼas qʼaxel u>tzij ri Dyos:
Juwinaq qʼataj.	Juwinaq qʼataj.
Rumal rech, che we man kkʼastaj ta kiwach ri ekaminaqibʼ, xoqujeʼ, ri Kristo, man xkʼastaj ta uwach riʼ.	R>umal rech, ch>e we man k>kʼastaj ta ki>wach ri e>kaminaq>ibʼ, xoqujeʼ, ri Kristo, man x>kʼastaj ta u>wach riʼ.
Michup bʼaʼ ri Tyoxlaj Uxlabʼxel,	M>i>chup bʼaʼ ri Tyoxlaj Uxlabʼxel,
